Menu - члены
.NET Framework 4
Другие версии 
Данная публикация была переведена вручную для обеспечения более высокого качества. Для одновременного отображения текущей страницы и страницы с исходным англоязычным контентом щелкните "Предпочтения" и выберите пункт "Классический" в качестве предпочитаемого отображения.


Представляет Windows элементы управления меню, позволяющие иерархически организовать элементы, связанные с командами и обработчиками событий. 

Тип Menu предоставляет следующие члены.
Конструкторы
  	Имя	Описание
	Menu	Инициализирует новый экземпляр класса Menu. 

В начало страницы
Методы
  	Имя	Описание
	AddChild	Добавляет заданный объект в качестве дочернего объекта ItemsControl. (Унаследовано от ItemsControl.)
	AddHandler(RoutedEvent, Delegate)	Добавляет обработчик перенаправленного события для указанного перенаправленного события, помещая обработчик в коллекцию обработчиков текущего элемента. (Унаследовано от UIElement.)
	AddHandler(RoutedEvent, Delegate, Boolean)	Добавляет обработчик маршрутизированного события для указанного перенаправленного события, помещая обработчик в коллекцию обработчиков настоящего элемента.Для вызова обработчика для перенаправленного события, которое уже было отмечено, как обработанное другим элементом, следует поменять значение handledEventsToo на true. (Унаследовано от UIElement.)
	AddLogicalChild	Добавляет указанный объект в логическое дерево данного элемента. (Унаследовано от FrameworkElement.)
	AddText	Добавляет заданную текстовую строку к объекту ItemsControl. (Унаследовано от ItemsControl.)
	AddToEventRoute	Добавляет обработчики в указанный EventRoute для настоящего коллекции обработчиков событий UIElement. (Унаследовано от UIElement.)
	AddVisualChild	Определяет связь "родитель-потомок" между двумя визуальными объектами. (Унаследовано от Visual.)
	ApplyAnimationClock(DependencyProperty, AnimationClock)	Применяет анимацию к указанному свойству зависимостей данного элемента.Все существующие анимации останавливаются и заменяются новой анимацией. (Унаследовано от UIElement.)
	ApplyAnimationClock(DependencyProperty, AnimationClock, HandoffBehavior)	Применяет анимацию к указанному свойству зависимостей данного элемента, с возможностью указать, что произойдет, если у свойства уже запущена анимация. (Унаследовано от UIElement.)
	ApplyTemplate	Выполняет построение визуального дерева текущего шаблона (при необходимости) и возвращает значение, показывающее, было ли перестроено визуальное дерево данным вызовом. (Унаследовано от FrameworkElement.)
	Arrange	Позиционирует дочерние элементы и определяет размер для UIElement.Родительские элементы вызывают этот метод из своей реализации ArrangeCore (или эквивалента уровня среды WPF), формируя рекурсивное обновление структуры.Этот метод составляет второй проход обновления структуры. (Унаследовано от UIElement.)
	ArrangeCore	Реализует метод ArrangeCore (определенный как виртуальный в классе UIElement) и запечатывает реализацию. (Унаследовано от FrameworkElement.)
	ArrangeOverride	Вызывается, чтобы разместить и масштабировать содержимое объекта Control. (Унаследовано от Control.)
	BeginAnimation(DependencyProperty, AnimationTimeline)	Запускает анимацию для указанного анимированного свойства данного элемента. (Унаследовано от UIElement.)
	BeginAnimation(DependencyProperty, AnimationTimeline, HandoffBehavior)	Запускает указанную анимацию для указанного анимированного свойства зависимостей этого элемента, с возможностью указания действий, которые следует предпринять при уже существующей анимации для данного свойства. (Унаследовано от UIElement.)
	BeginInit	Указывает на скорый запуск инициализации объекта ItemsControl. (Унаследовано от ItemsControl.)
	BeginStoryboard(Storyboard)	Начинает последовательность действий, содержащихся в предоставленной раскадровке. (Унаследовано от FrameworkElement.)
	BeginStoryboard(Storyboard, HandoffBehavior)	Начинает последовательность действий, содержащихся в предоставленной раскадровке, с параметрами, указывающими на реакцию в случае уже анимированного свойства. (Унаследовано от FrameworkElement.)
	BeginStoryboard(Storyboard, HandoffBehavior, Boolean)	Начинает последовательность действий, содержащихся в предоставленной раскадровке, с указанным состоянием элемента управления анимацией после ее запуска. (Унаследовано от FrameworkElement.)
	BringIntoView()	Пытается отобразить данный элемент вместе с содержащимися в нем прокручиваемыми областями. (Унаследовано от FrameworkElement.)
	BringIntoView(Rect)	Пытается отобразить указанный размер области данного элемента вместе с содержащимися в нем прокручиваемыми областями. (Унаследовано от FrameworkElement.)
	CaptureMouse	Предпринимает попытку захвата мыши данным элементом. (Унаследовано от UIElement.)
	CaptureStylus	Пытается принудительно захватить перо данным элементом. (Унаследовано от UIElement.)
	CaptureTouch	Предпринимает попытку принудительного получения операции сенсорного ввода данным элементом. (Унаследовано от UIElement.)
	CheckAccess	Определяет, имеет ли вызывающий поток доступ к этому DispatcherObject. (Унаследовано от DispatcherObject.)
	ClearContainerForItemOverride	При переопределении в производном классе отменяет действия метода PrepareContainerForItemOverride. (Унаследовано от ItemsControl.)
	ClearValue(DependencyProperty)	Очищает локальное значение свойства.Очищаемое свойство задается идентификатором DependencyProperty. (Унаследовано от DependencyObject.)
	ClearValue(DependencyPropertyKey)	Очищает локальное значение свойства, доступного только для чтения.Очищаемое свойство задается объектом DependencyPropertyKey. (Унаследовано от DependencyObject.)
	CoerceValue	Осуществляет приведение значения указанного свойства зависимостей.Это осуществляется путем вызова какой-либо функции CoerceValueCallback, указанной в метаданных свойства зависимостей, которое существует в вызывающем объекте DependencyObject. (Унаследовано от DependencyObject.)
	ContainerFromElement(DependencyObject)	Возвращает контейнер, принадлежащий текущему ItemsControl, содержащему заданный элемент. (Унаследовано от ItemsControl.)
	EndInit	Указывает на завершение инициализации объекта ItemsControl. (Унаследовано от ItemsControl.)
	Equals	Определяет, является ли указанный DependencyObject эквивалентом текущего DependencyObject. (Унаследовано от DependencyObject.)
	Finalize	Позволяет объекту Object попытаться освободить ресурсы и выполнить другие операции очистки, перед тем как объект Object будет утилизирован в процессе сборки мусора. (Унаследовано от Object.)
	FindCommonVisualAncestor	Возвращает общего предка двух визуальных объектов. (Унаследовано от Visual.)
	FindName	Находит элемент по указанному имени идентификатора. (Унаследовано от FrameworkElement.)
	FindResource	Осуществляет поиск ресурса с указанным ключом и вызывает исключение, если запрошенный ресурс не найден. (Унаследовано от FrameworkElement.)
	Focus	Попытка задать фокус для данного элемента. (Унаследовано от UIElement.)
	GetAnimationBaseValue	Возвращает базовое значение заданного свойства данного элемента, без учета возможного анимированного значения при запущенной или остановленной анимации. (Унаследовано от UIElement.)
	GetBindingExpression	Возвращает выражение BindingExpression, представляющее привязку для указанного свойства. (Унаследовано от FrameworkElement.)
	GetContainerForItemOverride	Создает или идентифицирует элемент, используемый для отображения заданного элемента. (Унаследовано от MenuBase.)
	GetHashCode	Возвращает хэш-код для данного DependencyObject. (Унаследовано от DependencyObject.)
	GetLayoutClip	Возвращает геометрию маски отсечения.Маска применяется при попытке системы структуры скомпоновать элемент, размер которого превышает доступное экранное пространство. (Унаследовано от FrameworkElement.)
	GetLocalValueEnumerator	Создает специализированный перечислитель для определения свойств зависимостей, которые локально установили значения для данного DependencyObject. (Унаследовано от DependencyObject.)
	GetTemplateChild	Не используется.Вместо этого следует использовать метод FindName. (Унаследовано от FrameworkElement.)
	GetType	Возвращает объект Type для текущего экземпляра. (Унаследовано от Object.)
	GetUIParentCore	Возвращает альтернативный логический родитель для данного элемента при отсутствии визуального родителя. (Унаследовано от FrameworkElement.)
	GetValue	Возвращает текущее действующее значение свойства зависимостей в данном экземпляре DependencyObject. (Унаследовано от DependencyObject.)
	GetVisualChild	Переопределяет метод Visual.GetVisualChild и возвращает дочерний элемент по указанному индексу из коллекции дочерних элементов. (Унаследовано от FrameworkElement.)
	HandleMouseButton	Вызывается нажатием или освобождением любой кнопки мыши. (Переопределяет MenuBase.HandleMouseButton(MouseButtonEventArgs).)
	HitTestCore(GeometryHitTestParameters)	Реализует метод Visual.HitTestCore, обеспечивая поведение проверки местонахождения пера для базового элемента (возвращая GeometryHitTestResult). (Унаследовано от UIElement.)
	HitTestCore(PointHitTestParameters)	Реализует HitTestCore, обеспечивая поведение проверки местонахождения пера для базового элемента (возвращая HitTestResult). (Унаследовано от UIElement.)
	InputHitTest	Возвращает элемент ввода, расположенный внутри текущего элемента по указанным координатам относительно начала координат текущего элемента. (Унаследовано от UIElement.)
	InvalidateArrange	Делает недействительным состояние компоновки (структуру) элемента.После этого структура элемента будет обновлена, что произойдет асинхронно, если не сделать это принудительно методом UpdateLayout. (Унаследовано от UIElement.)
	InvalidateMeasure	Делает недействительным состояние измерения (структуру) элемента. (Унаследовано от UIElement.)
	InvalidateProperty	Повторно вычисляет действующее значение для указанного свойства зависимостей (Унаследовано от DependencyObject.)
	InvalidateVisual	Делает недействительной отрисовку элемента и принудительно выполняет новый полный проход макета.По завершении цикла макета вызывается метод OnRender. (Унаследовано от UIElement.)
	IsAncestorOf	Определяет, является ли визуальный объект предком потомка визуального объекта. (Унаследовано от Visual.)
	IsDescendantOf	Определяет, является ли визуальный объект потомком для предка визуального объекта. (Унаследовано от Visual.)
	IsItemItsOwnContainerOverride	Определяет, является ли заданный элемент (или может являться) контейнером собственных элементов. (Унаследовано от MenuBase.)
	Measure	Обновляет свойство DesiredSize объекта UIElement.Родительские элементы вызывают данный метод из своих реализаций метода MeasureCore, формируя рекурсивное обновление структуры.Вызов этого метода составляет первый проход (проход измерения) при обновлении структуры. (Унаследовано от UIElement.)
	MeasureCore	Реализует основное поведение системы структуры при проходе измерения для FrameworkElement. (Унаследовано от FrameworkElement.)
	MeasureOverride	Вызывается, чтобы повторно измерить элемент управления. (Унаследовано от Control.)
	MemberwiseClone	Создает неполную копию текущего объекта Object. (Унаследовано от Object.)
	MoveFocus	Перемещает клавиатурный фокус от данного элемента на другой элемент в указанном направлении обхода. (Унаследовано от FrameworkElement.)
	OnAccessKey	Предоставляет обработку класса на случай вызова клавиши доступа, которая имеет значение для данного элемента. (Унаследовано от UIElement.)
	OnAlternationCountChanged	Вызывается при изменении свойства AlternationCount. (Унаследовано от ItemsControl.)
	OnApplyTemplate	При переопределении в производном классе вызывается каждый раз, когда код приложения или внутренние процессы вызывают ApplyTemplate. (Унаследовано от FrameworkElement.)
	OnChildDesiredSizeChanged	Поддерживает поведение структуры при изменении размеров дочернего элемента. (Унаследовано от UIElement.)
	OnContextMenuClosing	Вызывается, когда необработанное перенаправленное событие ContextMenuClosing достигает этого класса на своем пути.Реализация этого метода позволяет добавить обработчик класса для данного события. (Унаследовано от FrameworkElement.)
	OnContextMenuOpening	Вызывается, когда необработанное перенаправленное событие ContextMenuOpening достигает этого класса на своем пути.Реализация этого метода позволяет добавить обработчик класса для данного события. (Унаследовано от FrameworkElement.)
	OnCreateAutomationPeer	Обеспечивает соответствующую реализацию MenuAutomationPeer для данного элемента управления как часть инфраструктуры автоматизации WPF. (Переопределяет UIElement.OnCreateAutomationPeer().)
	OnDisplayMemberPathChanged	Вызывается при изменении свойства DisplayMemberPath. (Унаследовано от ItemsControl.)
	OnDragEnter	Вызывается, когда необработанное вложенное событиеDragDrop.DragEnter встречает на своем пути элемент, производный от этого класса.Реализация этого метода позволяет добавить обработчик класса для данного события. (Унаследовано от UIElement.)
	OnDragLeave	Вызывается, когда необработанное вложенное событиеDragDrop.DragLeave встречает на своем пути элемент, производный от этого класса.Реализация этого метода позволяет добавить обработчик класса для данного события. (Унаследовано от UIElement.)
	OnDragOver	Вызывается, когда необработанное вложенное событиеDragDrop.DragOver встречает на своем пути элемент, производный от этого класса.Реализация этого метода позволяет добавить обработчик класса для данного события. (Унаследовано от UIElement.)
	OnDrop	Вызывается, когда необработанное вложенное событиеDragDrop.DragEnter встречает на своем пути элемент, производный от этого класса.Реализация этого метода позволяет добавить обработчик класса для данного события. (Унаследовано от UIElement.)
	OnGiveFeedback	Вызывается, когда необработанное вложенное событиеDragDrop.GiveFeedback встречает на своем пути элемент, производный от этого класса.Реализация этого метода позволяет добавить обработчик класса для данного события. (Унаследовано от UIElement.)
	OnGotFocus	Вызывается, когда необработанное событие GotFocus достигает этого элемента на своем пути. (Унаследовано от FrameworkElement.)
	OnGotKeyboardFocus	Вызывается, когда необработанное вложенное событиеKeyboard.GotKeyboardFocus встречает на своем пути элемент, производный от этого класса.Реализация этого метода позволяет добавить обработчик класса для данного события. (Унаследовано от UIElement.)
	OnGotMouseCapture	Вызывается, когда необработанное вложенное событиеMouse.GotMouseCapture встречает на своем пути элемент, производный от этого класса.Реализация этого метода позволяет добавить обработчик класса для данного собы��ия. (Унаследовано от UIElement.)
	OnGotStylusCapture	Вызывается, когда необработанное вложенное событиеStylus.GotStylusCapture встречает на своем пути элемент, производный от этого класса.Реализация этого метода позволяет добавить обработчик класса для данного события. (Унаследовано от UIElement.)
	OnGotTouchCapture	Предоставляет обработку класса для перенаправленного события GotTouchCapture, которое происходит при захвате сенсорного ввода данным элементом. (Унаследовано от UIElement.)
	OnGroupStyleSelectorChanged	Вызывается при изменении свойства GroupStyleSelector. (Унаследовано от ItemsControl.)
	OnInitialized	Вызывается, когда значение свойства IsInitialized заданно равным true. (Переопределяет FrameworkElement.OnInitialized(EventArgs).)
	OnIsKeyboardFocusedChanged	Вызывается, когда в данном элементе инициируется необработанное событие IsKeyboardFocusedChanged.Реализация этого метода позволяет добавить обработку класса для данного события. (Унаследовано от UIElement.)
	OnIsKeyboardFocusWithinChanged	Отвечает на изменение свойства IsKeyboardFocusWithin. (Унаследовано от MenuBase.)
	OnIsMouseCapturedChanged	Вызывается, когда в данном элементе инициируется необработанное событие IsMouseCapturedChanged.Реализация этого метода позволяет добавить обработку класса для данного события. (Унаследовано от UIElement.)
	OnIsMouseCaptureWithinChanged	Вызывается, когда в данном элементе инициируется необработанное событие IsMouseCaptureWithinChanged.Реализация этого метода позволяет добавить обработку класса для данного события. (Унаследовано от UIElement.)
	OnIsMouseDirectlyOverChanged	Вызывается, когда в данном элементе инициируется необработанное событие IsMouseDirectlyOverChanged.Реализация этого метода позволяет добавить обработчик класса для данного события. (Унаследовано от UIElement.)
	OnIsStylusCapturedChanged	Вызывается, когда в данном элементе инициируется необработанное событие IsStylusCapturedChanged.Реализация этого метода позволяет добавить обработчик класса для данного события. (Унаследовано от UIElement.)
	OnIsStylusCaptureWithinChanged	Вызывается, когда в данном элементе инициируется необработанное событие IsStylusCaptureWithinChanged.Реализация этого метода позволяет добавить обработку класса для данного события. (Унаследовано от UIElement.)
	OnIsStylusDirectlyOverChanged	Вызывается, когда в данном элементе инициируется необработанное событие IsStylusDirectlyOverChanged.Реализация этого метода позволяет добавить обработчик класса для данного события. (Унаследовано от UIElement.)
	OnItemBindingGroupChanged	Вызывается при изменении свойства ItemBindingGroup. (Унаследовано от ItemsControl.)
	OnItemContainerStyleChanged	Вызывается при изменении свойства ItemContainerStyle. (Унаследовано от ItemsControl.)
	OnItemContainerStyleSelectorChanged	Вызывается при изменении свойства ItemContainerStyleSelector. (Унаследовано от ItemsControl.)
	OnItemsChanged	Вызывается при изменении свойства Items. (Унаследовано от ItemsControl.)
	OnItemsPanelChanged	Вызывается при изменении свойства ItemsPanel. (Унаследовано от ItemsControl.)
	OnItemsSourceChanged	Вызывается при изменении свойства ItemsSource. (Унаследовано от ItemsControl.)
	OnItemStringFormatChanged	Вызывается при изменении свойства ItemStringFormat. (Унаследовано от ItemsControl.)
	OnItemTemplateChanged	Вызывается при изменении свойства ItemTemplate. (Унаследовано от ItemsControl.)
	OnItemTemplateSelectorChanged	Вызывается при изменении свойства ItemTemplateSelector. (Унаследовано от ItemsControl.)
	OnKeyDown	Выполняет ответные действия при наступлении события KeyDown. (Переопределяет MenuBase.OnKeyDown(KeyEventArgs).)
	OnKeyUp	Вызывается, когда необработанное вложенное событиеKeyboard.KeyUp встречает на своем пути элемент, производный от этого класса.Реализация этого метода позволяет добавить обработчик класса для данного события. (Унаследовано от UIElement.)
	OnLostFocus	Инициирует перенаправленное событиеLostFocus, используя предоставленные данные события. (Унаследовано от UIElement.)
	OnLostKeyboardFocus	Вызывается, когда необработанное вложенное событиеKeyboard.LostKeyboardFocus встречает на своем пути элемент, производный от этого класса.Реализация этого метода позволяет добавить обработчик класса для данного события. (Унаследовано от UIElement.)
	OnLostMouseCapture	Вызывается, когда необработанное вложенное событиеMouse.LostMouseCapture встречает на своем пути элемент, производный от этого класса.Реализация этого метода позволяет добавить обработчик класса для данного события. (Унаследовано от UIElement.)
	OnLostStylusCapture	Вызывается, когда необработанное вложенное событиеStylus.LostStylusCapture встречает на своем пути элемент, производный от этого класса.Реализация этого метода позволяет добавить обработчик класса для данного события. (Унаследовано от UIElement.)
	OnLostTouchCapture	Предоставляет обработку класса для перенаправленного события LostTouchCapture, которое происходит при потере захвата сенсорного ввода данным элементом. (Унаследовано от UIElement.)
	OnManipulationBoundaryFeedback	Вызывается, когда происходит событие ManipulationBoundaryFeedback. (Унаследовано от UIElement.)
	OnManipulationCompleted	Вызывается, когда происходит событие ManipulationCompleted. (Унаследовано от UIElement.)
	OnManipulationDelta	Вызывается, когда происходит событие ManipulationDelta. (Унаследовано от UIElement.)
	OnManipulationInertiaStarting	Вызывается, когда происходит событие ManipulationInertiaStarting. (Унаследовано от UIElement.)
	OnManipulationStarted	Вызывается, когда происходит событие ManipulationStarted. (Унаследовано от UIElement.)
	OnManipulationStarting	Обеспечивает обработку класса для перенаправленного события ManipulationStarting, происходящего при первоначальном создании процессора манипулирования. (Унаследовано от UIElement.)
	OnMouseDoubleClick	Создает перенаправленное событие MouseDoubleClick. (Унаследовано от Control.)
	OnMouseDown	Вызывается, когда необработанное вложенное событиеMouse.MouseDown встречает на своем пути элемент, производный от этого класса.Реализация этого метода позволяет добавить обработчик класса для данного события. (Унаследовано от UIElement.)
	OnMouseEnter	Вызывается при получении данным элементом необработанного вложенного событияMouse.MouseEnter.Реализация этого метода позволяет добавить обработчик класса для данного события. (Унаследовано от UIElement.)
	OnMouseLeave	Предоставляет обработку класса для маршрутизируемого события MouseLeave, которое генерируется, когда мышь покидает элемент управления. (Унаследовано от MenuBase.)
	OnMouseLeftButtonDown	Вызывается, когда в данном элементе инициируется необработанное перенаправленное событиеMouseLeftButtonDown.Реализация этого метода позволяет добавить обработчик класса для данного события. (Унаследовано от UIElement.)
	OnMouseLeftButtonUp	Вызывается, когда необработанное маршрутизируемое событиеMouseLeftButtonUp обнаруживает на маршруте элемент, который является производным от данного класса.Реализация этого метода позволяет добавить обработчик класса для данного события. (Унаследовано от UIElement.)
	OnMouseMove	Вызывается, когда необработанное вложенное событиеMouse.MouseMove встречает на своем пути элемент, производный от этого класса.Реализация этого метода позволяет добавить обработчик класса для данного события. (Унаследовано от UIElement.)
	OnMouseRightButtonDown	Вызывается, когда необработанное маршрутизируемое событиеMouseRightButtonDown обнаруживает на маршруте элемент, кото��ый является производным от данного класса.Реализация этого метода позволяет добавить обработчик класса для данного события. (Унаследовано от UIElement.)
	OnMouseRightButtonUp	Вызывается, когда необработанное перенаправленное событиеMouseRightButtonUp встречает на своем пути элемент, производный от этого класса.Реализация этого метода позволяет добавить обработчик класса для данного события. (Унаследовано от UIElement.)
	OnMouseUp	Вызывается, когда необработанное маршрутизированное событиеMouse.MouseUp встречает на своем пути элемент, производный от этого класса.Реализация этого метода позволяет добавить обработчик класса для данного события. (Унаследовано от UIElement.)
	OnMouseWheel	Вызывается, когда необработанное вложенное событиеMouse.MouseWheel встречает на своем пути элемент, производный от этого класса.Реализация этого метода позволяет добавить обработчик класса для данного события. (Унаследовано от UIElement.)
	OnPreviewDragEnter	Вызывается, когда необработанное вложенное событиеDragDrop.PreviewDragEnter встречает на своем пути элемент, производный от этого класса.Реализация этого метода позволяет добавить обработчик класса для данного события. (Унаследовано от UIElement.)
	OnPreviewDragLeave	Вызывается, когда необработанное вложенное событиеDragDrop.PreviewDragLeave встречает на своем пути элемент, производный от этого класса.Реализация этого метода позволяет добавить обработчик класса для данного события. (Унаследовано от UIElement.)
	OnPreviewDragOver	Вызывается, когда необработанное вложенное событиеDragDrop.PreviewDragOver встречает на своем пути элемент, производный от этого класса.Реализация этого метода позволяет добавить обработчик класса для данного события. (Унаследовано от UIElement.)
	OnPreviewDrop	Вызывается, когда необработанное вложенное событиеDragDrop.PreviewDrop встречает на своем пути элемент, производный от этого класса.Реализация этого метода позволяет добавить обработчик класса для данного события. (Унаследовано от UIElement.)
	OnPreviewGiveFeedback	Вызывается, когда необработанное вложенное событиеDragDrop.PreviewGiveFeedback встречает на своем пути элемент, производный от этого класса.Реализация этого метода позволяет добавить обработчик класса для данного события. (Унаследовано от UIElement.)
	OnPreviewGotKeyboardFocus	Вызывается, когда необработанное вложенное событиеKeyboard.PreviewGotKeyboardFocus встречает на своем пути элемент, производный от этого класса.Реализация этого метода позволяет добавить обработчик класса для данного события. (Унаследовано от UIElement.)
	OnPreviewKeyDown	Вызывается, когда необработанное вложенное событиеKeyboard.PreviewKeyDown встречает на своем пути элемент, производный от этого класса.Реализация этого метода позволяет добавить обработчик класса для данного события. (Унаследовано от UIElement.)
	OnPreviewKeyUp	Вызывается, когда необработанное вложенное событиеKeyboard.PreviewKeyUp встречает на своем пути элемент, производный от этого класса.Реализация этого метода позволяет добавить обработчик класса для данного события. (Унаследовано от UIElement.)
	OnPreviewLostKeyboardFocus	Вызывается, когда необработанное вложенное собы��иеKeyboard.PreviewKeyDown встречает на своем пути элемент, производный от этого класса.Реализация этого метода позволяет добавить обработчик класса для данного события. (Унаследовано от UIElement.)
	OnPreviewMouseDoubleClick	Создает перенаправленное событие PreviewMouseDoubleClick. (Унаследовано от Control.)
	OnPreviewMouseDown	Вызывается, когда необработанное вложенное маршрутизированное событиеMouse.PreviewMouseDown достигает на своем пути элемента, производного от этого класса.Реализация этого метода позволяет добавить обработчик класса для данного события. (Унаследовано от UIElement.)
	OnPreviewMouseLeftButtonDown	Вызывается, когда необработанное перенаправленное событиеPreviewMouseLeftButtonDown встречает на своем пути элемент, производный от этого класса.Реализация этого метода позволяет добавить обработчик класса для данного события. (Унаследовано от UIElement.)
	OnPreviewMouseLeftButtonUp	Вызывается, когда необработанное маршрутизируемое событиеPreviewMouseLeftButtonUp обнаруживает на маршруте элемент, который является производным от данного класса.Реализация этого метода позволяет добавить обработчик класса для данного события. (Унаследовано от UIElement.)
	OnPreviewMouseMove	Вызывается, когда необработанное вложенное событиеMouse.PreviewMouseMove встречает на своем пути элемент, производный от этого класса.Реализация этого метода позволяет добавить обработчик класса для данного события. (Унаследовано от UIElement.)
	OnPreviewMouseRightButtonDown	Вызывается, когда необработанное перенаправленное событиеPreviewMouseRightButtonDown встречает на своем пути элемент, производный от этого класса.Реализация этого метода позволяет добавить обработчик класса для данного события. (Унаследовано от UIElement.)
	OnPreviewMouseRightButtonUp	Вызывается, когда необработанное перенаправленное событиеPreviewMouseRightButtonUp встречает на своем пути элемент, производный от этого класса.Реализация этого метода позволяет добавить обработчик класса для данного события. (Унаследовано от UIElement.)
	OnPreviewMouseUp	Вызывается, когда необработанное вложенное событиеMouse.PreviewMouseUp встречает на своем пути элемент, производный от этого класса.Реализация этого метода позволяет добавить обработчик класса для данного события. (Унаследовано от UIElement.)
	OnPreviewMouseWheel	Вызывается, когда необработанное вложенное событиеMouse.PreviewMouseWheel встречает на своем пути элемент, производный от этого класса.Реализация этого метода позволяет добавить обработчик класса для данного события. (Унаследовано от UIElement.)
	OnPreviewQueryContinueDrag	Вызывается, когда необработанное вложенное событиеDragDrop.PreviewQueryContinueDrag встречает на своем пути элемент, производный от этого класса.Реализация этого метода позволяет добавить обработчик класса для данного события. (Унаследовано от UIElement.)
	OnPreviewStylusButtonDown	Вызывается, когда необработанное вложенное событиеStylus.PreviewStylusButtonDown встречает на своем пути элемент, производный от этого класса.Реализация этого метода позволяет добавить обработчик класса для данного события. (Унаследовано от UIElement.)
	OnPreviewStylusButtonUp	Вызывается, когда необработанное вложенное событиеStylus.PreviewStylusButtonUp встречает на своем пути элемент, производный от этого класса.Реализация этого метода позволяет добавить обработчик класса для данного события. (Унаследовано от UIElement.)
	OnPreviewStylusDown	Вызывается, когда необработанное вложенное событиеStylus.PreviewStylusDown встречает на своем пути элемент, производный от этого класса.Реализация этого метода позволяет добавить обработчик класса для данного события. (Унаследовано от UIElement.)
	OnPreviewStylusInAirMove	Вызывается, когда необработанное вложенное событиеStylus.PreviewStylusInAirMove встречает на своем пути элемент, производный от этого класса.Реализация этого метода позволяет добавить обработчик класса для данного события. (Унаследовано от UIElement.)
	OnPreviewStylusInRange	Вызывается, когда необработанное вложенное событиеStylus.PreviewStylusInRange встречает на своем пути элемент, производный от этого класса.Реализация этого метода позволяет добавить обработчик класса для данного события. (Унаследовано от UIElement.)
	OnPreviewStylusMove	Вызывается, когда необработанное вложенное событиеStylus.PreviewStylusMove встречает на своем пути элемент, производный от этого класса.Реализация этого метода позволяет добавить обработчик класса для данного события. (Унаследовано от UIElement.)
	OnPreviewStylusOutOfRange	Вызывается, когда необработанное вложенное событиеStylus.PreviewStylusOutOfRange встречает на своем пути элемент, производный от этого класса.Реализация этого метода позволяет добавить обработчик класса для данного события. (Унаследовано от UIElement.)
	OnPreviewStylusSystemGesture	Вызывается, когда необработанное вложенное событиеStylus.PreviewStylusSystemGesture встречает на своем пути элемент, производный от этого класса.Реализация этого метода позволяет добавить обработчик класса для данного события. (Унаследовано от UIElement.)
	OnPreviewStylusUp	Вызывается, когда необработанное вложенное событиеStylus.PreviewStylusUp встречает на своем пути элемент, производный от этого класса.Реализация этого метода позволяет добавить обработчик класса для данного события. (Унаследовано от UIElement.)
	OnPreviewTextInput	Вызывается, когда необработанное вложенное событиеTextCompositionManager.PreviewTextInput встречает на своем пути элемент, производный от этого класса.Реализация этого метода позволяет добавить обработчик класса для данного события. (Унаследовано от UIElement.)
	OnPreviewTouchDown	Предоставляет обработку класса для перенаправленного события PreviewTouchDown, которое происходит при сенсорном нажатии данного элемента. (Унаследовано от UIElement.)
	OnPreviewTouchMove	Предоставляет обработку класса для маршрутизируемого события PreviewTouchMove, которое происходит при перемещении касания внутри этого элемента. (Унаследовано от UIElement.)
	OnPreviewTouchUp	Предоставляет обработку класса для перенаправленного события PreviewTouchUp, которое происходит при прекращении сенсорного нажатия внутри элемента. (Унаследовано от UIElement.)
	OnPropertyChanged	Вызывается при обновлении действующего значения какого-либо свойства зависимостей в данном FrameworkElement.Конкретное измененное свойство зависимостей сообщается в параметре аргументов.Переопределяет метод OnPropertyChanged. (Унаследовано от FrameworkElement.)
	OnQueryContinueDrag	Вызывается, когда необработанное вложенное событиеDragDrop.QueryContinueDrag встречает на своем пути элемент, производный от этого класса.Реализация этого метода позволяет добавить обработчик класса для данного события. (Унаследовано от UIElement.)
	OnQueryCursor	Вызывается, когда необработанное вложенное событиеMouse.QueryCursor встречает на своем пути элемент, производный от этого класса.Реализация этого метода позволяет добавить обработчик класса для данного события. (Унаследовано от UIElement.)
	OnRender	При переопределении в производном классе участвует в операциях отрисовки, направляемых системой структуры.Инструкции отрисовки для данного элемента не используются непосредственно при вызове данного метода, а вместо этого сохраняются для последующего асинхронного использования при структурировании и рисовании. (Унаследовано от UIElement.)
	OnRenderSizeChanged	Инициирует событие SizeChanged, используя указанную информацию как часть окончательных данных события. (Унаследовано от FrameworkElement.)
	OnStyleChanged	Вызывается при изменении текущего стиля данного элемента, что ведет к недействительности структуры. (Унаследовано от FrameworkElement.)
	OnStylusButtonDown	Вызывается, когда необработанное вложенное событиеStylus.StylusButtonDown обнаруживает на маршруте элемент, который является производным от данного класса.Реализация этого метода позволяет добавить обработчик класса для данного события. (Унаследовано от UIElement.)
	OnStylusButtonUp	Вызывается, когда необработанное вложенное событиеStylus.StylusButtonUp встречает на своем пути элемент, производный от этого класса.Реализация этого метода позволяет добавить обработчик класса для данного события. (Унаследовано от UIElement.)
	OnStylusDown	Вызывается, когда необработанное вложенное событиеStylus.StylusDown встречает на своем пути элемент, производный от этого класса.Реализация этого метода позволяет добавить обработчик класса для данного события. (Унаследовано от UIElement.)
	OnStylusEnter	Вызывается при получении данным элементом необработанного вложенного событияStylus.StylusEnter.Реализация этого метода позволяет добавить обработчик класса для данного события. (Унаследовано от UIElement.)
	OnStylusInAirMove	Вызывается, когда необработанное вложенное событиеStylus.StylusInAirMove встречает на своем пути элемент, производный от этого класса.Реализация этого метода позволяет добавить обработчик класса для данного события. (Унаследовано от UIElement.)
	OnStylusInRange	Вызывается, когда необработанное вложенное событиеStylus.StylusInRange встречает на своем пути элемент, производный от этого класса.Реализация этого метода позволяет добавить обработчик класса для данного события. (Унаследовано от UIElement.)
	OnStylusLeave	Вызывается при получении данным элементом необработанного вложенного событияStylus.StylusLeave.Реализация этого метода позволяет добавить обработчик класса для данного события. (Унаследовано от UIElement.)
	OnStylusMove	Вызывается, когда необработанное вложенное событиеStylus.StylusMove встречает на своем пути элемент, производный от этого класса.Реализация этого метода позволяет добавить обработчик класса для данного события. (Унаследовано от UIElement.)
	OnStylusOutOfRange	Вызывается, когда необработанное вложенное событиеStylus.StylusOutOfRange встречает на своем пути элемент, производный от этого класса.Реализация этого метода позволяет добавить обработчик класса для данного события. (Унаследовано от UIElement.)
	OnStylusSystemGesture	Вызывается, когда необработанное вложенное событиеStylus.StylusSystemGesture встречает на своем пути элемент, производный от этого класса.Реализация этого метода позволяет добавить обработчик класса для данного события. (Унаследовано от UIElement.)
	OnStylusUp	Вызывается, когда необработанное вложенное событиеStylus.StylusUp встречает на своем пути элемент, производный от этого класса.Реализация этого метода позволяет добавить обработчик класса для данного события. (Унаследовано от UIElement.)
	OnTemplateChanged	Вызывается при изменении шаблона элемента управления. (Унаследовано от Control.)
	OnTextInput	Обрабатывает перенаправленное событие TextInput, которое происходит, когда меню принимает текст, введенный из любого устройства. (Переопределяет ItemsControl.OnTextInput(TextCompositionEventArgs).)
	OnToolTipClosing	Вызывается, когда необработанное маршрутизируемое событие ToolTipClosing достигает этого класса на своем пути.Реализация этого метода позволяет добавить обработчик класса для данного события. (Унаследовано от FrameworkElement.)
	OnToolTipOpening	Вызывается, когда перенаправленное событие ToolTipOpening достигает этого класса на своем пути.Реализация этого метода позволяет добавить обработчик класса для данного события. (Унаследовано от FrameworkElement.)
	OnTouchDown	Предоставляет обработку класса для перенаправленного события TouchDown, которое происходит при сенсорном нажатии внутри данного элемента. (Унаследовано от UIElement.)
	OnTouchEnter	Предоставляет обработку класса для перенаправленного события TouchEnter, которое происходит при сенсорном перемещении внутрь данного элемента. (Унаследовано от UIElement.)
	OnTouchLeave	Предоставляет обработку класса для перенаправленного события TouchLeave, которое происходит при сенсорном перемещении из данного элемента UIElement за его пределы. (Унаследовано от UIElement.)
	OnTouchMove	Предоставляет обработку класса для перенаправленного события TouchMove, которое происходит при перемещении касания внутри этого элемента. (Унаследовано от UIElement.)
	OnTouchUp	Предоставляет обработку класса для перенаправленного события TouchUp, которое происходит при прекращении сенсорного нажатия внутри элемента. (Унаследовано от UIElement.)
	OnVisualChildrenChanged	Вызывается, если коллекция VisualCollection визуального объекта изменяется. (Унаследовано от Visual.)
	OnVisualParentChanged	Вызывается при изменении родителя данного элемента в визуальном дереве.Переопределяет метод OnVisualParentChanged. (Унаследовано от FrameworkElement.)
	ParentLayoutInvalidated	Поддерживает добавочные реализации структуры в специализированных подклассах FrameworkElement.Метод ParentLayoutInvalidated вызывается, когда дочерний элемент делает недействительным свойство, помеченное в метаданных как влияющее на проходы измерения или компоновки родительского элемента во время структурирования. (Унаследовано от FrameworkElement.)
	PointFromScreen	Преобразовывает объект Point в экранных координатах в объект Point, представляющий текущую систему координат Visual. (Унаследовано от Visual.)
	PointToScreen	Преобразовывает объект Point, представляющий текущую систему координат объекта Visual, в объект Point в экранных координатах. (Унаследовано от Visual.)
	PredictFocus	Определяет следующий элемент, который получит фокус, относительно данного элемента для указанного направления движения фокуса, но реально фокус не перемещает. (Унаследовано от FrameworkElement.)
	PrepareContainerForItemOverride	Подготавливает заданный элемент-контейнер для отображения указанного элемента. (Переопределяет ItemsControl.PrepareContainerForItemOverride(DependencyObject, Object).)
	RaiseEvent	Инициирует конкретное перенаправленное событие.Инициируемый RoutedEvent идентифицируется внутри предоставленного экземпляра RoutedEventArgs (как свойство RoutedEvent соответствующих данных события). (Унаследовано от UIElement.)
	ReadLocalValue	Возвращает локальное значение свойства зависимости, если таковое существует. (Унаследовано от DependencyObject.)
	RegisterName	Предоставляет метод доступа, упрощающий доступ к методу регистрации NameScope. (Унаследовано от FrameworkElement.)
	ReleaseAllTouchCaptures	Освобождает все полученные сенсорные устройства для данного элемента. (Унаследовано от UIElement.)
	ReleaseMouseCapture	Освобождает мышь, если элемент произвел ее захват. (Унаследовано от UIElement.)
	ReleaseStylusCapture	Освобождает захват перьевого устройства, если его удерживал данный элемент. (Унаследовано от UIElement.)
	ReleaseTouchCapture	Предпринимает попытку освободить заданное сенсорное устройство из этого элемента. (Унаследовано от UIElement.)
	RemoveHandler	Удаляет из данного элемента указанный обработчик перенаправленного события. (Унаследовано от UIElement.)
	RemoveLogicalChild	Удаляет указанный объект из логического дерева данного элемента.Объект FrameworkElement обновляет затронутые указатели родительских элементов в логическом дереве для поддержания синхронизации с данным удалением. (Унаследовано от FrameworkElement.)
	RemoveVisualChild	Удаляет связь "родитель-потомок" между двумя визуальными объектами. (Унаследовано от Visual.)
	SetBinding(DependencyProperty, String)	Прикрепляет привязку к данному элементу на основе указанного имени исходного свойства в виде классификационного пути к источнику данных. (Унаследовано от FrameworkElement.)
	SetBinding(DependencyProperty, BindingBase)	Прикрепляет привязку к данному элементу на основе указанного объекта привязки. (Унаследовано от FrameworkElement.)
	SetCurrentValue	Задает значение свойства зависимостей, не меняя источник значения. (Унаследовано от DependencyObject.)
	SetResourceReference	Выполняет поиск ресурса по указанному имени и устанавливает ссылку на этот ресурс для указанного свойства. (Унаследовано от FrameworkElement.)
	SetValue(DependencyProperty, Object)	Задает локальное значение свойства зависимостей, указанного идентификатором этого свойства. (Унаследовано от DependencyObject.)
	SetValue(DependencyPropertyKey, Object)	Задает локальное значение доступного только для чтения свойства зависимостей, указанного идентификатором DependencyPropertyKey. (Унаследовано от DependencyObject.)
	ShouldApplyItemContainerStyle	Возвращает значение, указывающее применение стиля из свойства ItemContainerStyle или ItemContainerStyleSelector к элементу контейнера указанного элемента. (Унаследовано от ItemsControl.)
	ShouldSerializeCommandBindings	Возвращает логическое значение, указывающее, следует ли процессам сериализации сериализировать содержимое свойства CommandBindings в экземплярах данного класса. (Унаследовано от UIElement.)
	ShouldSerializeGroupStyle	Возвращает значение, указывающее должны ли процессы сериализации сериализовать эффективное значение свойства GroupStyle. (Унаследовано от ItemsControl.)
	ShouldSerializeInputBindings	Возвращает логическое значение, указывающее, следует ли процессам сериализации сериализировать содержимое свойства InputBindings в экземплярах данного класса. (Унаследовано от UIElement.)
	ShouldSerializeItems	Возвращает значение, указывающее должны ли процессы сериализации выполнять сериализацию эффективного значения свойства Items. (Унаследовано от ItemsControl.)
	ShouldSerializeProperty	Возвращает значение, указывающее, следует ли процессам сериализации сериализовать значение для указанного свойства зависимостей. (Унаследовано от DependencyObject.)
	ShouldSerializeResources	Возвращает логическое значение, указывающее, следует ли процессам сериализации сериализировать содержимое свойства Resources. (Унаследовано от FrameworkElement.)
	ShouldSerializeStyle	Возвращает логическое значение, указывающее, следует ли процессам сериализации сериализировать содержимое свойства Style. (Унаследовано от FrameworkElement.)
	ShouldSerializeTriggers	Возвращает логическое значение, указывающее, следует ли процессам сериализации сериализировать содержимое свойства Triggers. (Унаследовано от FrameworkElement.)
	ToString	Предоставляет строковое представление объекта ItemsControl. (Унаследовано от ItemsControl.)
	TransformToAncestor(Visual)	Возвращает преобразование, которое может использоваться для преобразования координат этого объекта Visual в координаты заданного предка визуального объекта Visual. (Унаследовано от Visual.)
	TransformToAncestor(Visual3D)	Возвращает преобразование, которое может использоваться для преобразования координат этого объекта Visual в координаты заданного предка визуального объекта Visual3D. (Унаследовано от Visual.)
	TransformToDescendant	Возвращает преобразование, которое может использоваться для преобразования координат этого объекта Visual в координаты заданного потомка визуального объекта. (Унаследовано от Visual.)
	TransformToVisual	Возвращает преобразование, которое может использоваться для преобразования координат этого объекта Visual в координаты заданного визуального объекта. (Унаследовано от Visual.)
	TranslatePoint	Преобразует точку относительно данного элемента в координаты относительно указанного элемента. (Унаследовано от UIElement.)
	TryFindResource	Выполняет поиск ресурса по указанному ключу и возвращает этот ресурс, если он найден. (Унаследовано от FrameworkElement.)
	UnregisterName	Упрощает доступ к методу отмены регистрации NameScope. (Унаследовано от FrameworkElement.)
	UpdateLayout	Обеспечивает правильное обновление всех визуальных дочерних элементов данного элемента для структуры. (Унаследовано от UIElement.)
	VerifyAccess	Обеспечивает наличие у вызывающего потока доступ к этому DispatcherObject. (Унаследовано от DispatcherObject.)

В начало страницы
Поля
  	Имя	Описание
	IsMainMenuProperty	Определяет свойство зависимостей IsMainMenu. 

В начало страницы
Свойства
  	Имя	Описание
	ActualHeight	Возвращает визуализированную высоту данного элемента. (Унаследовано от FrameworkElement.)
	ActualWidth	Возвращает визуализированную ши��ину данного элемента. (Унаследовано от FrameworkElement.)
	AllowDrop	Получает или задает значение, указывающее, может ли данный элемент использоваться в качестве приемника операции перетаскивания. (Унаследовано от UIElement.)
	AlternationCount	Возвращает или задает количество чередующихся контейнеров элементов в объекте ItemsControl, который позволяет чередующимся контейнерам иметь уникальный внешний вид. (Унаследовано от ItemsControl.)
	AreAnyTouchesCaptured	Получает значение, которое указывает, была ли хотя бы одна операция сенсорного ввода передана в данный элемент. (Унаследовано от UIElement.)
	AreAnyTouchesCapturedWithin	Получает значение, указывающее, была ли хотя бы одна операция сенсорного ввода передана в данный элемент или в какой-либо из его дочерних элементов в визуальном дереве. (Унаследовано от UIElement.)
	AreAnyTouchesDirectlyOver	Получает значение, которое указывает, произошло ли хотя бы одно сенсорное нажатие данного элемента. (Унаследовано от UIElement.)
	AreAnyTouchesOver	Получает значение, указывающее, произошло ли хотя бы одно сенсорное нажатие данного элемента или какого-либо из его дочерних элементов в визуальном дереве. (Унаследовано от UIElement.)
	Background	Возвращает или задает кисть, которая описывает фон элемента управления. (Унаследовано от Control.)
	BindingGroup	Возвращает или задает группу BindingGroup, которая используется для элемента. (Унаследовано от FrameworkElement.)
	BitmapEffect	Устаревшее. Возвращает или задает растровый эффект, который применяется непосредственно к визуализированному содержимому данного элемента. (Унаследовано от UIElement.)
	BitmapEffectInput	Устаревшее. Возвращает или задает входной источник растрового эффекта, который применяется непосредственно к визуализированному содержимому данного элемента. (Унаследовано от UIElement.)
	BorderBrush	Возвращает или задает кисть, которая описывает фоновый цвет границы элемента управления. (Унаследовано от Control.)
	BorderThickness	Возвращает или задает толщину границы элемента управления. (Унаследовано от Control.)
	CacheMode	Получает или задает кэшированное представление объекта UIElement. (Унаследовано от UIElement.)
	Clip	Возвращает или задает геометрию, используемую для определения контура содержимого элемента. (Унаследовано от UIElement.)
	ClipToBounds	Возвращает или задает значение, указывающее, отсекать ли содержимое данного элемента (или содержимое из дочерних элементов данного элемента), чтобы оно уместилось в размер содержащего элемента. (Унаследовано от UIElement.)
	CommandBindings	Получает коллекцию объектов CommandBinding, сопоставленных с этим элементом.Привязка CommandBinding включает обработку команды для данного элемента и объявляет связь между командой, ее событиями и обработчиками, присоединенные данным элементом. (Унаследовано от UIElement.)
	ContextMenu	Возвращает или задает элемент контекстного меню, который должен отображаться всякий раз при запросе контекстного меню через пользовательский интерфейс изнутри данного элемента. (Унаследовано от FrameworkElement.)
	Cursor	Возвращает или задает курсор, отображаемый, когда указатель мыши находится над данным элементом. (Унаследовано от FrameworkElement.)
	DataContext	Возвращает или задает контекст данных для элемента, участвующего в привязке данных. (Унаследовано от FrameworkElement.)
	DefaultStyleKey	Возвращает или задает ключ, используемый для ссылки на стиль данного элемента управления, при использовании или определении тематических стилей. (Унаследовано от FrameworkElement.)
	DependencyObjectType	Возвращает DependencyObjectType, который создает обертку для типа CLR данного экземпляра.  (Унаследовано от DependencyObject.)
	DesiredSize	Возвращает размер, вычисленный данным элементом при проходе измерения в процессе структурирования. (Унаследовано от UIElement.)
	Dispatcher	Возвращает объект Dispatcher, с которым связан этот объект DispatcherObject. (Унаследовано от DispatcherObject.)
	DisplayMemberPath	Возвращает или задает путь к значению в объекте источника в качестве визуального представления объекта. (Унаследовано от ItemsControl.)
	Effect	Получает или задает эффект растрового изображения, применяемый к объекту UIElement. (Унаследовано от UIElement.)
	FlowDirection	Возвращает или задает направление потока текста и других элементов пользовательский интерфейс внутри любого родительского элемента, управляющего их структурой. (Унаследовано от FrameworkElement.)
	Focusable	Возвращает или задает значение, указывающее, может ли элемент получать фокус. (Унаследовано от UIElement.)
	FocusVisualStyle	Возвращает или задает свойство, делающее возможной настройку внешнего вида, эффектов или других характеристик стиля, применяемых к данному элементу при захвате им клавиатурного фокуса. (Унаследовано от FrameworkElement.)
	FontFamily	Возвращает или задает семейство шрифтов элемента управления. (Унаследовано от Control.)
	FontSize	Получает или задает размер шрифта. (Унаследовано от Control.)
	FontStretch	Возвращает или задает степень сжатия или расширения шрифта на экране. (Унаследовано от Control.)
	FontStyle	Возвращает или задает стиль шрифта. (Унаследовано от Control.)
	FontWeight	Возвращает или задает плотность или толщину указанного шрифта. (Унаследовано от Control.)
	ForceCursor	Возвращает или задает значение, указывающее, следует ли данному FrameworkElement заставлять пользовательский интерфейс визуализировать курсор, как объявлено свойством Cursor. (Унаследовано от FrameworkElement.)
	Foreground	Возвращает или задает кисть, которая описывает основной цвет. (Унаследовано от Control.)
	GroupStyle	Получает коллекцию объектов GroupStyle, определяющих отображение каждого уровня групп. (Унаследовано от ItemsControl.)
	GroupStyleSelector	Возвращает или задает метод, позволяющий предоставить пользовательскую логику выбора для GroupStyle для применения к каждой группе в коллекции. (Унаследовано от ItemsControl.)
	HandlesScrolling	Возвращает значение, указывающее, поддерживает ли элемент управления прокрутку. (Унаследовано от Control.)
	HasAnimatedProperties	Возвращает значение, указывающее, имеет ли данный элемент какие-либо анимированные свойства. (Унаследовано от UIElement.)
	HasItems	Получает значение, указывающее содержит ли ItemsControl элементы. (Унаследовано от ItemsControl.)
	Height	Возвращает или задает предполагаемую высоту элемента. (Унаследовано от FrameworkElement.)
	HorizontalAlignment	Возвращает или задает горизонтальные характеристики выравнивания, примененные к данному элементу при его создании в родительском элементе, например панели или коллекции элементов. (Унаследовано от FrameworkElement.)
	HorizontalContentAlignment	Возвращает или задает способ горизонтального выравнивания содержимого элемента управления. (Унаследовано от Control.)
	InheritanceBehavior	Возвращает или задает пределы области видимости для наследования значений свойств и поиска ключей ресурсов. (Унаследовано от FrameworkElement.)
	InputBindings	Возвращает коллекцию привязок ввода, связанных с данным элементом. (Унаследовано от UIElement.)
	InputScope	Получает или задает контекст для ввода, используемый данным объектом FrameworkElement. (Унаследовано от FrameworkElement.)
	IsArrangeValid	Возвращает значение, указывающее, являются ли действительными вычисленные размер и позиция дочерних элементов в структуре данного элемента. (Унаследовано от UIElement.)
	IsEnabled	Получает или задает значение, указывающее, активирован ли этот элемент в пользовательский интерфейс. (Унаследовано от UIElement.)
	IsEnabledCore	Возвращает значение, которое становится возвращаемым значением свойства IsEnabled в производных классах. (Унаследовано от UIElement.)
	IsFocused	Получает значение, определяющее, имеет ли элемент логический фокус. (Унаследовано от UIElement.)
	IsGrouping	Получает значение, указывающее использует ли данный элемент управления группирование. (Унаследовано от ItemsControl.)
	IsHitTestVisible	Возвращает или задает значение, объявляющее, может ли данный элемент быть возвращен как результат проверки нажатия в некоторой части его визуализированного содержимого. (Унаследовано от UIElement.)
	IsInitialized	Возвращает значение, показывающее, был ли инициализирован данный элемент — либо в ходе обработки процессором Язык XAML, либо путем явного вызова его метода EndInit.  (Унаследовано от FrameworkElement.)
	IsInputMethodEnabled	Получает значение, указывающее, активирована ли система метода ввода (например, Редактор метода ввода (IME)) для обработки ввода на данный элемент. (Унаследовано от UIElement.)
	IsKeyboardFocused	Получает значение, указывающее, имеет ли элемент фокус клавиатуры. (Унаследовано от UIElement.)
	IsKeyboardFocusWithin	Получает значение, указывающее, находится ли фокус клавиатуры на элементе или его дочерних элементах визуального дерева. (Унаследовано от UIElement.)
	IsLoaded	Возвращает значение, указывающее, загружен ли данный элемент для презентации. (Унаследовано от FrameworkElement.)
	IsMainMenu	Возвращает или задает значение, показывающее, получает ли Menu уведомления об активации основного меню. 
	IsManipulationEnabled	Получает или задает значение, которое определяет, включены ли события манипулирования для данного элемента UIElement. (Унаследовано от UIElement.)
	IsMeasureValid	Возвращает значение, указывающее, действителен ли текущий размер, возвращенный измерением структуры. (Унаследовано от UIElement.)
	IsMouseCaptured	Получает значение, указывающее, захвачена ли мышь этим элементом. (Унаследовано от UIElement.)
	IsMouseCaptureWithin	Возвращает значение, определяющее, удерживается ли захват мыши данным элементом или дочерними элементами его визуального дерева. (Унаследовано от UIElement.)
	IsMouseDirectlyOver	Возвращает значение, определяющее, соответствует ли позиция указателя мыши результатам проверки нажатия, учитывающей композицию элемента. (Унаследовано от UIElement.)
	IsMouseOver	Возвращает значение, указывающее, находится ли указатель мыши над данным элементом (включая дочерние элементы визуального дерева). (Унаследовано от UIElement.)
	IsSealed	Получает значение, указывающее, является ли этот экземпляр в данный момент запечатанным (доступным только для чтения). (Унаследовано от DependencyObject.)
	IsStylusCaptured	Получает значение, определяющее, захвачено ли перо данным элементом. (Унаследовано от UIElement.)
	IsStylusCaptureWithin	Возвращает значение, определяющее, удерживается ли захват пера данным элементом или элементом в пределах его границ и визуального дерева. (Унаследовано от UIElement.)
	IsStylusDirectlyOver	Получает значение, определяющее, соответствует ли позиция пера результатам проверки нажатия, учитывающей композицию элемента. (Унаследовано от UIElement.)
	IsStylusOver	Возвращает значение, указывающее, находится ли курсор пера на элементе (включая видимые дочерние элементы). (Унаследовано от UIElement.)
	IsTabStop	Возвращает или задает значение, показывающее, включается ли элемент управления в переходы по ТАВ. (Унаследовано от Control.)
	IsTextSearchCaseSensitive	Получает или задает значение, указывающее, учитывается ли регистр при поиске элементов. (Унаследовано от ItemsControl.)
	IsTextSearchEnabled	Возвращает или задает значение, указывающее включен ли TextSearch в экземпляре ItemsControl. (Унаследовано от ItemsControl.)
	IsVisible	Получает значение, указывающее, видим ли этот элемент в пользовательский интерфейс. (Унаследовано от UIElement.)
	ItemBindingGroup	Возвращает или задает объект BindingGroup, который копируется в каждый элемент в объекте ItemsControl. (Унаследовано от ItemsControl.)
	ItemContainerGenerator	Получает ItemContainerGenerator, связанный с элементом управления. (Унаследовано от ItemsControl.)
	ItemContainerStyle	Возвращает или задает Style, применяемый к элементу контейнера, сгенерированному для каждого элемента. (Унаследовано от ItemsControl.)
	ItemContainerStyleSelector	Возвращает или задает пользовательскую логику выбора стиля для стиля, который может быть применен к каждому сгенерированному элементу контейнера. (Унаследовано от ItemsControl.)
	Items	Получает коллекцию, используемую для генерирования содержимого ItemsControl. (Унаследовано от ItemsControl.)
	ItemsPanel	Возвращает или задает шаблон, определяющий панель, управляющую размещением элементов. (Унаследовано от ItemsControl.)
	ItemsSource	Возвращает или задает коллекцию, используемую для генерирования содержимого ItemsControl. (Унаследовано от ItemsControl.)
	ItemStringFormat	Возвращает или задает составную строку, которая определяет форматирование элементов в объектах ItemsControl, если они отображаются как строки. (Унаследовано от ItemsControl.)
	ItemTemplate	Возвращает или задает DataTemplate, используемый для отображения каждого элемента. (Унаследовано от ItemsControl.)
	ItemTemplateSelector	Возвращает или задает пользовательскую логику для выбора шаблона, используемого для отображения каждого элемента. (Унаследовано от ItemsControl.)
	Language	Получает или задает языковую информацию для локализации/глобализации, применяемую к элементу. (Унаследовано от FrameworkElement.)
	LayoutTransform	Возвращает или задает графическое преобразование, которое следует применять к данному элементу при выполнении структурирования. (Унаследовано от FrameworkElement.)
	LogicalChildren	Получает перечислитель для логических дочерних объектов объекта ItemsControl. (Унаследовано от ItemsControl.)
	Margin	Возвращает или задает внешнее поле элемента. (Унаследовано от FrameworkElement.)
	MaxHeight	Возвращает или задает максимальное ограничение высоты элемента. (Унаследовано от FrameworkElement.)
	MaxWidth	Возвращает или задает максимальное ограничение ширины элемента. (Унаследовано от FrameworkElement.)
	MinHeight	Возвращает или задает минимальное ограничение высоты элемента. (Унаследовано от FrameworkElement.)
	MinWidth	Возвращает или задает минимальное ограничение ширины элемента. (Унаследовано от FrameworkElement.)
	Name	Возвращает или задает идентификационное имя элемента.Имя позволяет обращаться из с выделенным кодом, например из кода обработчика событий, к элементу разметки после его создания в ходе обработки процессором Язык XAML. (Унаследовано от FrameworkElement.)
	Opacity	Возвращает или задает коэффициент непрозрачности, применяемый ко всему UIElement при его отрисовке в пользовательский интерфейс. (Унаследовано от UIElement.)
	OpacityMask	Получает или задает маску прозрачности как реализацию Brush, которая применяется к любой маскировке альфа-канала для отрисовываемого содержимого данного элемента. (Унаследовано от UIElement.)
	OverridesDefaultStyle	Возвращает или задает значение, показывающее, содержит ли данный элемент свойства стиля из тематических стилей. (Унаследовано от FrameworkElement.)
	Padding	Возвращает или задает заполнение элемента управления. (Унаследовано от Control.)
	Parent	Возвращает логический родительский элемент для данного элемента. (Унаследовано от FrameworkElement.)
	PersistId	Устаревшее. Возвращает значение, уникальным образом идентифицирующее данный элемент. (Унаследовано от UIElement.)
	RenderSize	Возвращает (или задает, см. примечания) финальный размер отрисовки данного элемента. (Унаследовано от UIElement.)
	RenderTransform	Возвращает или задает информацию о преобразовании, которая влияет на позицию отрисовки данного элемента. (Унаследовано от UIElement.)
	RenderTransformOrigin	Возвращает или задает центральную точку любого возможного преобразования визуализации, объявленного свойством RenderTransform, относительно границ элемента. (Унаследовано от UIElement.)
	Resources	Возвращает или задает локально определенный словарь ресурсов. (Унаследовано от FrameworkElement.)
	SnapsToDevicePixels	Возвращает или задает значение, определяющее, следует ли использовать при отрисовке данного элемента специфические для устройства точечные настройки. (Унаследовано от UIElement.)
	Style	Возвращает или задает стиль, используемый данным элементом при визуализации. (Унаследовано от FrameworkElement.)
	StylusPlugIns	Возвращает коллекцию всех подключаемых (настраиваемых) объектов пера, связанных с данным элементом. (Унаследовано от UIElement.)
	TabIndex	Возвращает или задает значение, определяющее порядок, в котором элементы получают фокус, когда пользователь переходит между элементами управления с помощью клавиши ТАВ. (Унаследовано от Control.)
	Tag	Возвращает или задает произвольное значение объекта, которое может использоваться для хранения специальной информации о данном элементе. (Унаследовано от FrameworkElement.)
	Template	Возвращает или задает шаблон элемента управления. (Унаследовано от Control.)
	TemplatedParent	Возвращает ссылку на родитель шаблона данного элемента.Данное свойство не имеет смысла, если элемент не был создан с помощью шаблона. (Унаследовано от FrameworkElement.)
	ToolTip	Получает или задает объект подсказки, отображаемый для данного элемента в пользовательский интерфейс. (Унаследовано от FrameworkElement.)
	TouchesCaptured	Получает все сенсорные устройства, переданные в данный элемент. (Унаследовано от UIElement.)
	TouchesCapturedWithin	Получает все сенсорные устройства, переданные в этот элемент или какой-либо из его дочерних элементов в визуальном дереве. (Унаследовано от UIElement.)
	TouchesDirectlyOver	Получает все сенсорные устройства, находящиеся над данным элементом. (Унаследовано от UIElement.)
	TouchesOver	Получает все сенсорные устройства, находящиеся над этим элементом или каким-либо из его дочерних элементов в визуальном дереве. (Унаследовано от UIElement.)
	Triggers	Возвращает коллекцию триггеров, установленных непосредственно для данного элемента или дочерних элементов. (Унаследовано от FrameworkElement.)
	Uid	Возвращает или задает идентификатор для данного элемента. (Унаследовано от UIElement.)
	UseLayoutRounding	Получает или задает значение, указывающее, следует ли применять округление структуры для размера и позиции данного элемента во время структурирования. (Унаследовано от FrameworkElement.)
	VerticalAlignment	Возвращает или задает вертикальные характеристики выравнивания, примененные к данному элементу при его создании в родительском элементе, например панели или коллекции элементов. (Унаследовано от FrameworkElement.)
	VerticalContentAlignment	Возвращает или задает способ вертикального выравнивания содержимого элемента управления. (Унаследовано от Control.)
	Visibility	Получает или задает видимость данного элемента в пользовательский интерфейс. (Унаследовано от UIElement.)
	VisualBitmapEffect	Устаревшее. Получает или задает значение BitmapEffect для объекта Visual. (Унаследовано от Visual.)
	VisualBitmapEffectInput	Устаревшее. Получает или задает значение BitmapEffectInput для объекта Visual. (Унаследовано от Visual.)
	VisualBitmapScalingMode	Возвращает или задает BitmapScalingMode для Visual. (Унаследовано от Visual.)
	VisualCacheMode	Получает или задает кэшированное представление объекта Visual. (Унаследовано от Visual.)
	VisualChildrenCount	Возвращает число визуальных дочерних элементов внутри данного элемента. (Унаследовано от FrameworkElement.)
	VisualClearTypeHint	Получает или задает объект ClearTypeHint, который определяет способ отображения ClearType в Visual. (Унаследовано от Visual.)
	VisualClip	Возвращает или задает отсеченную область объекта Visual в виде значения Geometry. (Унаследовано от Visual.)
	VisualEdgeMode	Возвращает или задает края объекта Visual в виде значения EdgeMode. (Унаследовано от Visual.)
	VisualEffect	Получает или задает эффект растрового изображения, который применяется к объекту Visual. (Унаследовано от Visual.)
	VisualOffset	Возвращает или задает значение смещения визуального объекта. (Унаследовано от Visual.)
	VisualOpacity	Возвращает или задает значение непрозрачности для объекта Visual. (Унаследовано от Visual.)
	VisualOpacityMask	Возвращает или задает значение Brush, которое представляет маску непрозрачности объекта Visual. (Унаследовано от Visual.)
	VisualParent	Получает для визуального объекта родительский объект визуального дерева. (Унаследовано от Visual.)
	VisualScrollableAreaClip	Получает или задает обрезанную прокручиваемую область для объекта Visual. (Унаследовано от Visual.)
	VisualTextHintingMode	Получает или задает экземпляр TextHintingMode для компонента Visual. (Унаследовано от Visual.)
	VisualTextRenderingMode	Получает или задает экземпляр TextRenderingMode для компонента Visual. (Унаследовано от Visual.)
	VisualTransform	Возвращает или задает значение Transform для объекта Visual. (Унаследовано от Visual.)
	VisualXSnappingGuidelines	Возвращает или задает коллекцию (вертикальных) направляющих для координаты x. (Унаследовано от Visual.)
	VisualYSnappingGuidelines	Возвращает или задает коллекцию (горизонтальных) направляющих для координаты y. (Унаследовано от Visual.)
	Width	Возвращает или задает ширину элемента. (Унаследовано от FrameworkElement.)

В начало страницы
События
  	Имя	Описание
	ContextMenuClosing	Происходит непосредственно перед закрытием какого-либо контекстного меню в элементе. (Унаследовано от FrameworkElement.)
	ContextMenuOpening	Происходит при открытии какого-либо контекстного меню в элементе. (Унаследовано от FrameworkElement.)
	DataContextChanged	Происходит при изменении контекста данных данного элемента. (Унаследовано от FrameworkElement.)
	DragEnter	Происходит, когда система ввода сообщает об основном событии перетаскивания, в котором данный элемент является местом назначения. (Унаследовано от UIElement.)
	DragLeave	Происходит, когда система ввода сообщает об основном событии перетаскивания, в котором данный элемент является изначальным местом положения объекта. (Унаследовано от UIElement.)
	DragOver	Происходит, когда система ввода сообщает об основном событии перетаскивания, в котором данный элемент является потенциальным местом назначения. (Унаследовано от UIElement.)
	Drop	Происходит, когда система ввода сообщает об основном событии перетаскивания, в котором данный элемент является местом назначения. (Унаследовано от UIElement.)
	FocusableChanged	Происходит при изменении значения свойства Focusable. (Унаследовано от UIElement.)
	GiveFeedback	Происходит, когда система ввода сообщает об основном событии перетаскивания, в котором используется данный элемент. (Унаследовано от UIElement.)
	GotFocus	Происходит, когда элемент получает фокус. (Унаследовано от UIElement.)
	GotKeyboardFocus	Происходит при перемещении фокуса на этот элемент при помощи клавиатуры. (Унаследовано от UIElement.)
	GotMouseCapture	Происходит, когда элемент получает мышь. (Унаследовано от UIElement.)
	GotStylusCapture	Происходит, когда элемент захватывает перо. (Унаследовано от UIElement.)
	GotTouchCapture	Происходит при получении данным элементом операции сенсорного ввода. (Унаследовано от UIElement.)
	Initialized	Происходит во время инициализации данного FrameworkElement.Данное событие совпадает со случаями, когда значение свойства IsInitialized изменяется с false (или неопределенного) на true. (Унаследовано от FrameworkElement.)
	IsEnabledChanged	Происходит при изменении значения свойства IsEnabled данного элемента. (Унаследовано от UIElement.)
	IsHitTestVisibleChanged	Происходит при изменении значения свойства зависимостей IsHitTestVisible данного элемента. (Унаследовано от UIElement.)
	IsKeyboardFocusedChanged	Происходит при изменении значения свойства IsKeyboardFocused данного элемента. (Унаследовано от UIElement.)
	IsKeyboardFocusWithinChanged	Происходит при изменении значения свойства IsKeyboardFocusWithinChanged данного элемента. (Унаследовано от UIElement.)
	IsMouseCapturedChanged	Происходит при изменении значения свойства IsMouseCaptured данного элемента. (Унаследовано от UIElement.)
	IsMouseCaptureWithinChanged	Происходит при изменении значения поля IsMouseCaptureWithinProperty данного элемента. (Унаследовано от UIElement.)
	IsMouseDirectlyOverChanged	Происходит при изменении значения свойства IsMouseDirectlyOver данного элемента. (Унаследовано от UIElement.)
	IsStylusCapturedChanged	Происходит при изменении значения свойства IsStylusCaptured данного элемента. (Унаследовано от UIElement.)
	IsStylusCaptureWithinChanged	Происходит при изменении значения свойства IsStylusCaptureWithin данного элемента. (Унаследовано от UIElement.)
	IsStylusDirectlyOverChanged	Происходит при изменении значения свойства IsStylusDirectlyOver данного элемента. (Унаследовано от UIElement.)
	IsVisibleChanged	Происходит при изменении значения свойства IsVisible данного элемента. (Унаследовано от UIElement.)
	KeyDown	Происходит при нажатии клавиши, если фокус находится на данном элементе. (Унаследовано от UIElement.)
	KeyUp	Происходит при отжатии клавиши, если элемент имеет фокус. (Унаследовано от UIElement.)
	LayoutUpdated	Происходит при изменении структуры различных визуальных элементов, связанных с текущим Dispatcher. (Унаследовано от UIElement.)
	Loaded	Происходит при размещении, визуализации элемента и его готовности к взаимодействию. (Унаследовано от FrameworkElement.)
	LostFocus	Происходит, когда данный элемент теряет логический фокус. (Унаследовано от UIElement.)
	LostKeyboardFocus	Происходит при перемещении фокуса с этого элемента при помощи клавиатуры. (Унаследовано от UIElement.)
	LostMouseCapture	Происходит, когда элемент утрачивает захват мыши. (Унаследовано от UIElement.)
	LostStylusCapture	Происходит, когда элемент теряет захват пера. (Унаследовано от UIElement.)
	LostTouchCapture	Происходит, когда элемент теряет касание. (Унаследовано от UIElement.)
	ManipulationBoundaryFeedback	Происходит, когда манипуляция сталкивается с границей. (Унаследовано от UIElement.)
	ManipulationCompleted	Происходит, когда манипуляция над объектом UIElement и инерция завершены. (Унаследовано от UIElement.)
	ManipulationDelta	Происходит, когда устройство ввода меняет положение в процессе манипуляции. (Унаследовано от UIElement.)
	ManipulationInertiaStarting	Происходит, когда устройство ввода теряет контакт с объектом UIElement в процессе манипуляции и начинается инерция. (Унаследовано от UIElement.)
	ManipulationStarted	Происходит, когда устройство ввода начинает совершать манипуляцию над объектом UIElement. (Унаследовано от UIElement.)
	ManipulationStarting	Происходит при первоначальном создании процессора манипулирования. (Унаследовано от UIElement.)
	MouseDoubleClick	Происходит при нажатии кнопки мыши два или более раз. (Унаследовано от Control.)
	MouseDown	Происходит при нажатии кнопки мыши, если указатель мыши находится на элементе. (Унаследовано от UIElement.)
	MouseEnter	Происходит, когда указатель мыши входит в пределы элемента. (Унаследовано от UIElement.)
	MouseLeave	Происходит, когда указатель мыши покидает пределы элемента. (Унаследовано от UIElement.)
	MouseLeftButtonDown	Происходит при нажатии левой кнопки мыши, если указатель мыши находится на элементе. (Унаследовано от UIElement.)
	MouseLeftButtonUp	Происходит при освобождении левой кнопки мыши, если указатель мыши находится на элементе. (Унаследовано от UIElement.)
	MouseMove	Происходит, когда указатель мыши совершает движение по этому элементу. (Унаследовано от UIElement.)
	MouseRightButtonDown	Происходит при нажатии правой кнопки мыши, если указатель мыши находится на элементе. (Унаследовано от UIElement.)
	MouseRightButtonUp	Происходит при отпускании правой кнопки мыши, если указатель мыши находится на элементе. (Унаследовано от UIElement.)
	MouseUp	Происходит, когда кнопка мыши отпускается на элементе. (Унаследовано от UIElement.)
	MouseWheel	Происходит при прокрутке пользователем колесика мыши, если указатель мыши находится на элементе. (Унаследовано от UIElement.)
	PreviewDragEnter	Происходит, когда система ввода сообщает об основном событии перетаскивания, в котором данный элемент является местом назначения. (Унаследовано от UIElement.)
	PreviewDragLeave	Происходит, когда система ввода сообщает об основном событии перетаскивания, в котором данный элемент является изначальным местом положения объекта. (Унаследовано от UIElement.)
	PreviewDragOver	Происходит, когда система ввода сообщает об основном событии перетаскивания, в котором данный элемент является потенциальным местом назначения. (Унаследовано от UIElement.)
	PreviewDrop	Происходит, когда система ввода сообщает об основном событии перетаскивания, в котором данный элемент является местом назначения. (Унаследовано от UIElement.)
	PreviewGiveFeedback	Генерируется в начале операции перетаскивания. (Унаследовано от UIElement.)
	PreviewGotKeyboardFocus	Происходит при перемещении фокуса на этот элемент при помощи клавиатуры. (Унаследовано от UIElement.)
	PreviewKeyDown	Происходит при нажатии клавиши, когда фокус установлен на данном элементе. (Унаследовано от UIElement.)
	PreviewKeyUp	Происходит при отпускании клавиши, когда фокус установлен на данном элементе. (Унаследовано от UIElement.)
	PreviewLostKeyboardFocus	Происходит при перемещении фокуса с этого элемента при помощи клавиатуры. (Унаследовано от UIElement.)
	PreviewMouseDoubleClick	Происходит при нажатии кнопки мыши два или более раз. (Унаследовано от Control.)
	PreviewMouseDown	Происходит при нажатии кнопки мыши, если указатель мыши находится на элементе. (Унаследовано от UIElement.)
	PreviewMouseLeftButtonDown	Происходит при нажатии левой кнопки мыши, если указатель мыши находится на элементе. (Унаследовано от UIElement.)
	PreviewMouseLeftButtonUp	Происходит при освобождении левой кнопки мыши, если указатель мыши находится на элементе. (Унаследовано от UIElement.)
	PreviewMouseMove	Происходит при перемещении курсора мыши, если указатель мыши находится на элементе. (Унаследовано от UIElement.)
	PreviewMouseRightButtonDown	Происходит при нажатии правой кнопки мыши, если указатель мыши находится на элементе. (Унаследовано от UIElement.)
	PreviewMouseRightButtonUp	Происходит при отпускании правой кнопки мыши, если указатель мыши находится на элементе. (Унаследовано от UIElement.)
	PreviewMouseUp	Происходит при освобождении кнопки мыши, если указатель мыши находится на элементе. (Унаследовано от UIElement.)
	PreviewMouseWheel	Происходит при прокрутке пользователем колесика мыши, если указатель мыши находится на элементе. (Унаследовано от UIElement.)
	PreviewQueryContinueDrag	Происходит при изменении состояния клавиатуры или кнопки мыши во время операции перетаскивания. (Унаследовано от UIElement.)
	PreviewStylusButtonDown	Происходит при нажатии кнопки пера, если указатель мыши находится на элементе. (Унаследовано от UIElement.)
	PreviewStylusButtonUp	Происходит при отпускании кнопки пера, если указатель мыши находится на элементе. (Унаследовано от UIElement.)
	PreviewStylusDown	Происходит при контакте пера с диджитайзером, если указатель находится на элементе. (Унаследовано от UIElement.)
	PreviewStylusInAirMove	Происходит при движении пера над элементом без соприкосновения с диджитайзером. (Унаследовано от UIElement.)
	PreviewStylusInRange	Происходит, когда перо достаточно близко к диджитайзеру, чтобы быть замеченным, находясь над данным элементом. (Унаследовано от UIElement.)
	PreviewStylusMove	Происходит, когда перо совершает движение по этому элементу.Для возникновения данного события перо должно перемещаться в то время, когда оно обнаруживается дигитайзером; в противном случае вызывается событие PreviewStylusInAirMove. (Унаследовано от UIElement.)
	PreviewStylusOutOfRange	Происходит, когда расстояния между пером и диджитайзером слишком велико для определения пера. (Унаследовано от UIElement.)
	PreviewStylusSystemGesture	Происходит, когда пользователь делает одно из нескольких жестов пером. (Унаследовано от UIElement.)
	PreviewStylusUp	Происходит, когда пользователь отнимает перо от диджитайзера, когда оно находится над этим элементом. (Унаследовано от UIElement.)
	PreviewTextInput	Происходит, когда в этот элемент текст поступает аппаратно-независимым образом. (Унаследовано от UIElement.)
	PreviewTouchDown	Происходит при касании пальцем экрана, если палец при этом находится над данным элементом. (Унаследовано от UIElement.)
	PreviewTouchMove	Происходит при перемещении пальца по экрану, если палец при этом находится над данным элементом. (Унаследовано от UIElement.)
	PreviewTouchUp	Происходит при поднятии пальца от экрана, если палец при этом находится над данным элементом. (Унаследовано от UIElement.)
	QueryContinueDrag	Происходит при изменении состояния клавиатуры или кнопки мыши во время операции перетаскивания. (Унаследовано от UIElement.)
	QueryCursor	Происходит при получении запроса отображения курсора.Событие генерируется при каждом изменении положения указателя мыши на элементе, что означает возможную необходимость изменения объекта курсора в соответствии с новым положением. (Унаследовано от UIElement.)
	RequestBringIntoView	Происходит при вызове метода BringIntoView в данном элементе. (Унаследовано от FrameworkElement.)
	SizeChanged	Происходит при изменении значения любого из свойств ActualHeight или ActualWidth данного элемента. (Унаследовано от FrameworkElement.)
	SourceUpdated	Происходит при изменении исходного значения любого существующего свойства, привязанного к данному элементу. (Унаследовано от FrameworkElement.)
	StylusButtonDown	Происходит при нажатии кнопки пера, если указатель мыши находится на элементе. (Унаследовано от UIElement.)
	StylusButtonUp	Происходит при отпускании кнопки пера, если указатель мыши находится на элементе. (Унаследовано от UIElement.)
	StylusDown	Происходит при контакте пера с диджитайзером, если указатель находится на элементе. (Унаследовано от UIElement.)
	StylusEnter	Происходит, когда курсор пера входит в пределы этого элемента. (Унаследовано от UIElement.)
	StylusInAirMove	Происходит при движении пера над элементом без соприкосновения с диджитайзером. (Унаследовано от UIElement.)
	StylusInRange	Происходит, когда перо достаточно близко к диджитайзеру, чтобы быть замеченным, находясь над данным элементом. (Унаследовано от UIElement.)
	StylusLeave	Происходит, когда курсор пера покидает пределы этого элемента. (Унаследовано от UIElement.)
	StylusMove	Происходит, когда перо совершает движение по этому элементу.Для вызова данного события перо должно двигаться на планшете.В противном случае вместо данного события инициируется StylusInAirMove. (Унаследовано от UIElement.)
	StylusOutOfRange	Происходит, когда перо слишком далеко от диджитайзера, чтобы быть замеченным, находясь над данным элементом. (Унаследовано от UIElement.)
	StylusSystemGesture	Происходит, когда пользователь делает одно из нескольких жестов пером. (Унаследовано от UIElement.)
	StylusUp	Происходит, когда пользователь отнимает перо от диджитайзера, когда оно находится над этим элементом. (Унаследовано от UIElement.)
	TargetUpdated	Происходит при изменении целевого значения любого свойства, привязанного к данному элементу. (Унаследовано от FrameworkElement.)
	TextInput	Происходит, когда в этот элемент текст поступает аппаратно-независимым образом. (Унаследовано от UIElement.)
	ToolTipClosing	Происходит непосредственно перед закрытием какой-либо подсказки в элементе. (Унаследовано от FrameworkElement.)
	ToolTipOpening	Происходит при открытии какой-либо подсказки в элементе. (Унаследовано от FrameworkElement.)
	TouchDown	Происходит при касании пальцем экрана, если палец при этом находится над данным элементом. (Унаследовано от UIElement.)
	TouchEnter	Происходит при перемещении касания внутрь данного элемента. (Унаследовано от UIElement.)
	TouchLeave	Происходит при перемещении касания за границы элемента. (Унаследовано от UIElement.)
	TouchMove	Происходит при перемещении пальца по экрану, если палец при этом находится над данным элементом. (Унаследовано от UIElement.)
	TouchUp	Происходит при поднятии пальца от экрана, если палец при этом находится над данным элементом. (Унаследовано от UIElement.)
	Unloaded	Происходит при удалении элемента из дерева с загруженными элементами. (Унаследовано от FrameworkElement.)

В начало страницы
Явные реализации интерфейса
  	Имя	Описание
	IAddChild.AddChild	Данный член поддерживает инфраструктуру Windows Presentation Foundation (WPF) и не предназначен для непосредственного использования из кода. (Унаследовано от ItemsControl.)
	IAddChild.AddText	Данный член поддерживает инфраструктуру Windows Presentation Foundation (WPF) и не предназначен для непосредственного использования из кода. (Унаследовано от ItemsControl.)
	IQueryAmbient.IsAmbientPropertyAvailable