Конструкторы
  	Имя	Описание
	PathFigure	Перегружен. Инициализирует новый экземпляр класса PathFigure. 

В начало страницы
Методы
  	Имя	Описание
	ApplyAnimationClock	Перегружен. 
	BeginAnimation	Перегружен. 
	CheckAccess	Определяет, имеет ли вызывающий поток доступ к этому DispatcherObject. (Унаследовано от DispatcherObject.)
	ClearValue	Перегружен. 
	Clone	Создает модифицируемый клон данного объекта PathFigure, делая глубокие копии значений этого объекта. При копировании свойств зависимостей этот метод копирует ссылки на ресурсы и привязки данных (которые могут уже не быть разрешаемыми), но не копирует анимации и их текущие значения.
	CloneCore	Создает экземпляр копии (глубокой копии) заданного объекта Freezable, используя базовые (не анимационные) значения свойств. (Унаследовано от Freezable.)
	CloneCurrentValue	Создает модифицируемый клон данного объекта PathFigure, делая глубокие копии текущих значений этого объекта. Ссылки на ресурсы, привязки данных и анимации не копируются, в отличие от их текущих значений. 
	CloneCurrentValueCore	Создает экземпляр редактируемой копии (глубокой копии) заданного объекта Freezable, используя текущие значения свойства. (Унаследовано от Freezable.)
	CoerceValue	Осуществляет приведение значения указанного свойства зависимостей. Это осуществляется путем вызова какой-либо функции CoerceValueCallback, указанной в метаданных свойства зависимостей, которое существует в вызывающем объекте DependencyObject. (Унаследовано от DependencyObject.)
	CreateInstance	Инициализирует новый экземпляр класса Freezable. (Унаследовано от Freezable.)
	CreateInstanceCore	Если реализуется в производном классе, создает новый экземпляр производного класса Freezable. (Унаследовано от Freezable.)
	Equals	Определяет, является ли указанный DependencyObject эквивалентом текущего DependencyObject. (Унаследовано от DependencyObject.)
	Finalize	Позволяет объекту Object попытаться освободить ресурсы и выполнить другие операции очистки, перед тем как объект Object будет утилизирован в процессе сборки мусора. (Унаследовано от Object.)
	Freeze	Делает текущий объект нередактируемым и определяет для его свойства IsFrozen значение true. (Унаследовано от Freezable.)
	FreezeCore	Делает данный объект Animatable неизменяемым или определяет, может ли он быть сделан неизменяемым. (Унаследовано от Animatable.)
	GetAnimationBaseValue	Возвращает не анимированное значение указанного объекта DependencyProperty. (Унаследовано от Animatable.)
	GetAsFrozen	Создает фиксированную копию объекта Freezable, используя базовые (не анимационные) значения свойств. Так как копия является фиксированной, копируются только ссылки на фиксированные вложенные объекты. (Унаследовано от Freezable.)
	GetAsFrozenCore	Создает экземпляр фиксированной копии заданного объекта Freezable, используя базовые (не анимационные) значения свойства. (Унаследовано от Freezable.)
	GetCurrentValueAsFrozen	Создает фиксированную копию объекта Freezable с использованием текущих значений свойств. Так как копия является фиксированной, копируются только ссылки на фиксированные вложенные объекты. (Унаследовано от Freezable.)
	GetCurrentValueAsFrozenCore	Создает текущий экземпляр замороженной копии указанного объекта Freezable. Если объект имеет анимационные свойства зависимостей, копируются их текущие анимационные значения. (Унаследовано от Freezable.)
	GetFlattenedPathFigure	Перегружен. Получает объект PathFigure, являющийся кусочно-линейной аппроксимацией данного объекта PathFigure. 
	GetHashCode	Возвращает хэш-код для данного DependencyObject. (Унаследовано от DependencyObject.)
	GetLocalValueEnumerator	Создает специализированный перечислитель для определения свойств зависимостей, которые локально установили значения для данного DependencyObject. (Унаследовано от DependencyObject.)
	GetType	Возвращает объект Type для текущего экземпляра. (Унаследовано от Object.)
	GetValue	Возвращает текущее действующее значение свойства зависимостей в данном экземпляре DependencyObject. (Унаследовано от DependencyObject.)
	InvalidateProperty	Повторно вычисляет действующее значение для указанного свойства зависимостей (Унаследовано от DependencyObject.)
	MayHaveCurves	Определяет, может ли данный объект PathFigure иметь криволинейные сегменты. 
	MemberwiseClone	Создает неполную копию текущего объекта Object. (Унаследовано от Object.)
	OnChanged	Вызывается при изменении текущего объекта Freezable. (Унаследовано от Freezable.)
	OnFreezablePropertyChanged	Перегружен. 
	OnPropertyChanged	Переопределяет реализацию DependencyObject метода OnPropertyChanged, чтобы также вызывать любые обработчики Changed в ответ на изменение свойства зависимостей типа Freezable. (Унаследовано от Freezable.)
	ReadLocalValue	Возвращает локальное значение свойства зависимости, если таковое существует. (Унаследовано от DependencyObject.)
	ReadPreamble	Обеспечивает доступ к Freezable из допустимого потока. Наследники объекта Freezable должны вызывать данный метод в начале любого API-интерфейс, который считывает элементы данных, не являющиеся свойствами зависимостей. (Унаследовано от Freezable.)
	SetValue	Перегружен. 
	ShouldSerializeProperty	Возвращает значение, указывающее, следует ли процессам сериализации сериализовать значение для указанного свойства зависимостей. (Унаследовано от DependencyObject.)
	ToString	Перегружен. Создает строковое представление данного объекта.
	VerifyAccess	Обеспечивает наличие у вызывающего потока доступ к этому DispatcherObject. (Унаследовано от DispatcherObject.)
	WritePostscript	Вызывает событие Changed для объекта Freezable и вызывает его метод OnChanged. Классы, которые являются производными от класса Freezable, должны вызывать данный момент в конце любого интерфе��са API, который изменяет элементы класса, не сохраненные как свойства зависимостей. (Унаследовано от Freezable.)
	WritePreamble	Проверяет, что объект Freezable не является замороженным и доступ к нему выполняется из правильного потокового контекста. Наследники объекта Freezable должны вызывать данный метод в начале любого API-интерфейс, который выполняет запись в элементах данных, не являющихся свойствами зависимостей. (Унаследовано от Freezable.)

В начало страницы
Поля
  	Имя	Описание
	IsClosedProperty	Идентифицирует свойство зависимостейIsClosed.
	IsFilledProperty	Идентифицирует свойство зависимостейIsFilled. 
	SegmentsProperty	Идентифицирует свойство зависимостейSegments. 
	StartPointProperty	Идентификатор для StartPoint свойства зависимостей.

В начало страницы
Свойства
  	Имя	Описание
	CanFreeze	Возвращает значение, которое показывает, можно ли сделать объект нередактируемым. (Унаследовано от Freezable.)
	DependencyObjectType	Возвращает DependencyObjectType, который создает обертку для типа CLR данного экземпляра. (Унаследовано от DependencyObject.)
	Dispatcher	Возвращает объект Dispatcher, с которым связан этот объект DispatcherObject. (Унаследовано от DispatcherObject.)
	HasAnimatedProperties	Возвращает значение, которое указывает, сопоставлены ли один или несколько объектов AnimationClock любому из свойств зависимостей этого объекта. (Унаследовано от Animatable.)
	IsClosed	Получает или задает значение, указывающее, соединены ли первый и последний сегменты данной фигуры. Это свойство зависимостей. 
	IsFilled	Получает или задает значение, указывающее, должна ли область, содержащаяся в данном PathFigure, использоваться для проверки нажатия, отрисовки и обрезки. Это свойство зависимостей. 
	IsFrozen	Возвращает значение, которое показывает, является ли сейчас объект редактируемым. (Унаследовано от Freezable.)
	IsSealed	Возвращает значение, объявляющее, является ли данный экземпляр в данный момент доступным только для чтения. (Унаследовано от DependencyObject.)
	Segments	Получает или задает коллекцию сегментов, определяющих форму данного объекта PathFigure. Это свойство зависимостей. 
	StartPoint	Получает или задает значение Point, указывающее, где начинается PathFigure. Это свойство зависимостей. 

В начало страницы
События
  	Имя	Описание
	Changed	Происходит, когда изменяется класс Freezable или объект, который входит в его состав. (Унаследовано от Freezable.)

В начало страницы
Явные реализации интерфейса
  	Имя	Описание
	IFormattable.ToString	Данный член обеспечивает поддержку инфраструктуры Windows Presentation Foundation (WPF) и не предназначен для непосредственного использования в коде.