UIElement - класс

UIElement — это базовый класс для реализаций, относящихся у уровню ядра WPF, основывающийся на элементах Windows Presentation Foundation (WPF) и базовых характеристиках представления.

Иерархия наследования
System.Object 
  System.Windows.Threading.DispatcherObject
    System.Windows.DependencyObject
      System.Windows.Media.Visual
        System.Windows.UIElement
          System.Windows.FrameworkElement

Пространство имен:  System.Windows

[UidPropertyAttribute("Uid")]
public class UIElement : Visual, IAnimatable, IInputElement

Использование элемента объекта XAML
<UIElement .../>

Конструкторы

UIElement	Инициализирует новый экземпляр класса UIElement.

Свойства

 AllowDrop	Получение или установка значения, определяющего возможность использования элемента в качестве целевого объекта для операции перетаскивания. Это свойство зависимостей.
 AreAnyTouchesCaptured	Получает значение, которое указывает, была ли хотя бы одна операция сенсорного ввода передана в данный элемент
 AreAnyTouchesCapturedWithin	Получает значение, указывающее, была ли хотя бы одна операция сенсорного ввода передана в данный элемент или в какой-либо из его дочерних элементов в визуальном дереве.
 AreAnyTouchesDirectlyOver	Получает значение, которое указывает, произошло ли хотя бы одно сенсорное нажатие данного элемента.
 AreAnyTouchesOver	Получает значение, указывающее, произошло ли хотя бы одно сенсорное нажатие данного элемента или какого-либо из его дочерних элементов в визуальном дереве.
 BitmapEffect	Устарело. Получение или установка эффекта для точечных рисунков, который применяется непосредственно к отображаемому содержимому этого элемента. Это свойство зависимостей.
 BitmapEffectInput	Устарело. Получение или установка источника входных данных эффекта для точечных рисунков, который применяется непосредственно к отображаемому содержимому этого элемента. Это свойство зависимостей.
 CacheMode	Возвращает или задаёт кэшированное представление объекта UIElement.
 Clip	Получение или установка геометрии, определяющей контур для содержимого элемента. Это свойство зависимостей.
 ClipToBounds	Получение или установка значения, определяющего усечение содержимого этого элемента (или содержимого, поступающего из его дочерних элементов) в соответствии с размерами содержащего его элемента. Это свойство зависимостей.
 CommandBindings	Возвращает коллекцию объектов CommandBinding, сопоставленных с этим элементом. CommandBinding активирует обработку команды для данного элемента и объявляет связь между командой, присоединённой к данному элементу, её событиями и их обработчиками.
 DependencyObjectType	Возвращает DependencyObjectType, который создаёт обёртку для типа CLR данного экземпляра. (Унаследовано от DependencyObject.)
 DesiredSize	Возвращает размер, вычисленный данным элементом при проходе измерения в процессе макетирования.
 Dispatcher	Возвращает объект Dispatcher, с которым связан данный объект DispatcherObject. (Унаследовано от DispatcherObject.)
 Effect	Возвращает или задаёт эффект растрового изображения, применяемый к объекту UIElement. Это свойство зависимостей.
 Focusable	Получение или установка значения, определяющего возможность получения фокуса элементом. Это свойство зависимостей.
 HasAnimatedProperties	Возвращает значение, указывающее, имеет ли данный элемент какие-либо анимированные свойства.
 HasEffectiveKeyboardFocus	Возвращает значение, указывающее, установлен ли фокус на элементе UIElement.
 InputBindings	Возвращает коллекцию привязок ввода, связанных с данным элементом.
 IsArrangeValid	Возвращает значение, определяющее, являются ли действительными вычисленные размер и положение дочерних элементов в структуре данного элемента.
 IsEnabled	Получает или задает значение, указывающее, активирован ли этот элемент в пользовательский интерфейс. Это свойство зависимостей.
 IsEnabledCore	Возвращает значение, которое становится возвращаемым значением свойства IsEnabled в производных классах.
 IsFocused	Получает значение, определяющее, имеет ли элемент логический фокус. Это свойство зависимостей.
 IsHitTestVisible	Возвращает или задаёт значение, определяющее, может ли данный элемент быть возвращён как результат проверки нажатия в некоторой части его визуализированного содержимого. Это свойство зависимостей.
 IsInputMethodEnabled	Возвращает значение, указывающее, активирована ли система метода ввода, например Редактор метода ввода (IME), для обработки ввода в данный элемент.
 IsKeyboardFocused	Получает значение, указывающее, имеет ли элемент фокус клавиатуры. Это свойство зависимостей.
 IsKeyboardFocusWithin	Получает значение, указывающее, находится ли фокус клавиатуры на элементе или его дочерних элементах визуального дерева. Это свойство зависимостей.
 IsManipulationEnabled	Возвращает или задаёт значение, указывающее, активированы ли события манипулирования для этого элемента UIElement.
 IsMeasureValid	Возвращает значение, показывающее, действителен ли текущий размер, возвращённый процедурой измерения структуры.
 IsMouseCaptured	Получает значение, указывающее, захвачена ли мышь этим элементом. Это свойство зависимостей.
 IsMouseCaptureWithin	Возвращает значение, определяющее, удерживается ли захват мыши данным элементом или дочерними элементами его визуального дерева. Это свойство зависимостей.
 IsMouseDirectlyOver	Возвращает значение, определяющее, соответствует ли позиция указателя мыши результатам проверки нажатия, учитывающей композицию элемента. Это свойство зависимостей.
 IsMouseOver	Возвращает значение, указывающее, находится ли указатель мыши над данным элементом (включая дочерние элементы визуального дерева). Это свойство зависимостей.
 IsSealed	Возвращает значение, указывающее, является ли этот экземпляр в данный момент запечатанным (доступным только для чтения).(Унаследовано от DependencyObject.)
 IsStylusCaptured	Получает значение, определяющее, захвачено ли перо данным элементом. Это свойство зависимостей.
 IsStylusCaptureWithin	Возвращает значение, указывающее, удерживается ли захват пера данным элементом или элементом, находящимся в пределах его границ и его визуального дерева. Это свойство зависимостей.
 IsStylusDirectlyOver	Получает значение, указывающее, соответствует ли позиция пера результатам проверки нажатия, учитывающей композицию элемента. Это свойство зависимостей.
 IsStylusOver	Возвращает значение, указывающее, находится ли курсор пера на элементе (включая видимые дочерние элементы). Это свойство зависимостей.
 IsVisible	Получает значение, определяющее, видим ли этот элемент в пользовательский интерфейс. Это свойство зависимостей.
 Opacity	Возвращает или задает коэффициент непрозрачности, применяемый ко всему UIElement при его отрисовке в пользовательский интерфейс. Это свойство зависимостей.
 OpacityMask	Получает или задает маску прозрачности как реализацию Brush, которая применяется к любой маскировке альфа-канала для отрисовываемого содержимого данного элемента. Это свойство зависимостей.
 PersistId	Устарело. Возвращает значение, уникальным образом идентифицирующее данный элемент.
 RenderSize	Возвращает (или задаёт, см. примечания) окончательный размер отрисовки данного элемента.
 RenderTransform	Получение или установка сведений о преобразовании, которые влияют на положение отображения элемента. Это свойство зависимостей.
 RenderTransformOrigin	Возвращает или задает центральную точку любого возможного преобразования визуализации, объявленного свойством RenderTransform, относительно границ элемента. Это свойство зависимостей.
 SnapsToDevicePixels	Получение или установка значения, определяющего, должно ли отображение этого элемента выполняться с использованием определяемых устройством параметров пикселей. Это свойство зависимостей.
 StylusPlugIns	Возвращает коллекцию всех подключаемых (настраиваемых) объектов пера, связанных с данным элементом.
 TouchesCaptured	Возвращает все сенсорные нажатия, переданные в данный элемент.
 TouchesCapturedWithin	Возвращает все сенсорные нажатия, переданные в данный элемент или в какой-либо из дочерних элементов в его визуальном дереве. 
 TouchesDirectlyOver	Возвращает все сенсорные нажатия, произведённые поверх данного элемента.
 TouchesOver	Возвращает все сенсорные нажатия, произведённые поверх данного элемента или какого-либо из дочерних элементов в его визуальном дереве.
 Uid	Возвращает или задаёт уникальный идентификатор (для локализации) для данного элемента. Это свойство зависимостей.
 Visibility	Получает или задает видимость данного элемента в пользовательский интерфейс. Это свойство зависимостей.
 VisualBitmapEffect	Устарело. Возвращает или задаёт значение BitmapEffect для объекта Visual. (Унаследовано от Visual.)
 VisualBitmapEffectInput	Устарело. Возвращает или задаёт значение BitmapEffectInput для объекта Visual. (Унаследовано от Visual.)
 VisualBitmapScalingMode	Возвращает или задаёт режим BitmapScalingMode для объекта Visual. (Унаследовано от Visual.)
 VisualCacheMode	Возвращает или задаёт кэшированное представление объекта Visual. (Унаследовано от Visual.)
 VisualChildrenCount	Получает число дочерних элементов для объекта Visual. (Унаследовано от Visual.)
 VisualClearTypeHint	Возвращает или задаёт объект ClearTypeHint, который определяет способ отображения технологии ClearType в объекте Visual. (Унаследовано от Visual.)
 VisualClip	Возвращает или задаёт область отсечения объекта Visual в виде значения Geometry. (Унаследовано от Visual.)
 VisualEdgeMode	Возвращает или задаёт режим отображения границ объекта Visual в виде значения EdgeMode. (Унаследовано от Visual.)
 VisualEffect	Возвращает или задаёт эффект растрового изображения, который применяется к объекту Visual. (Унаследовано от Visual.)
 VisualOffset	Возвращает или задаёт значение смещения визуального объекта. (Унаследовано от Visual.)
 VisualOpacity	Возвращает или задаёт значение непрозрачности для объекта Visual. (Унаследовано от Visual.)
 VisualOpacityMask	Возвращает или задаёт значение кисти Brush, которое представляет маску непрозрачности для объекта Visual. (Унаследовано от Visual.)
 VisualParent	Возвращает для визуального объекта его родительский объект в визуальном дереве. (Унаследовано от Visual.)
 VisualScrollableAreaClip	Возвращает или задаёт обрезанную прокручиваемую область для объекта Visual. (Унаследовано от Visual.)
 VisualTextHintingMode	Возвращает или задаёт экземпляр TextHintingMode для объекта Visual (Унаследовано от Visual.)
 VisualTextRenderingMode	Возвращает или задаёт экземпляр TextRenderingMode для объекта Visual (Унаследовано от Visual.)
 VisualTransform	Возвращает или задаёт значение Transform для объекта Visual. (Унаследовано от Visual.)
 VisualXSnappingGuidelines	Возвращает или задаёт коллекцию вертикальных направляющих (по координате х). (Унаследовано от Visual.)
 VisualYSnappingGuidelines	Возвращает или задаёт коллекцию горизонтальных направляющих (по координате y). (Унаследовано от Visual.)

Методы

 AddHandler(RoutedEvent, Delegate)	Добавляет обработчик маршрутизируемого события для указанного маршрутизируемого события, помещая этот обработчик в коллекцию обработчиков текущего элемента.
 AddHandler(RoutedEvent, Delegate, Boolean)	Добавляет обработчик маршрутизируемого события для указанного маршрутизируемого события, помещая этот обработчик в коллекцию обработчиков текущего элемента. Чтобы этот обработчик вызывался для маршрутизируемого события, которое уже было отмечено в маршруте события другим элементом как обработанное, укажите для параметра handledEventsToo значение true.
 AddToEventRoute	Добавляет обработчики в указанный контейнер маршрута EventRoute для коллекции обработчиков событий текущего объекта UIElement
 AddVisualChild	Определяет связь "родитель-потомок" между двумя визуальными элементами. (Унаследовано от Visual.)
 ApplyAnimationClock(DependencyProperty, AnimationClock)	Применяет анимацию к указанному свойству зависимостей данного элемента. Все существующие анимации останавливаются и заменяются новой анимацией.
 ApplyAnimationClock(DependencyProperty, AnimationClock, HandoffBehavior)	Применяет анимацию к указанному свойству зависимостей данного элемента, с возможностью указания действий, которые следует предпринять в случае, если свойство уже имеет действующую анимацию.
 Arrange	Позиционирует дочерние элементы и определяет размер объекта UIElement. Родительские элементы вызывают этот метод из своей реализации метода ArrangeCore (или эквивалента уровня среды WPF), формируя рекурсивное обновление структуры. Этот метод представляет собой второй проход процедуры обновления структуры.
 ArrangeCore	Определяет шаблон для определения структуры упорядочивания уровня ядра WPF.
 BeginAnimation(DependencyProperty, AnimationTimeline)	Запускает анимацию для указанного анимированного свойства этого элемента.
 BeginAnimation(DependencyProperty, AnimationTimeline, HandoffBehavior)	Запускает указанную анимацию для указанного анимированного свойства этого элемента, с возможностью указания действий, которые следует предпринять в случае, если свойство уже имеет действующую анимацию.
 CaptureMouse	Пытается принудительно захватить мышь данным элементом.
 CaptureStylus	Пытается принудительно захватить перо данным элементом.
 CaptureTouch	Пытается принудительно захватить сенсорный экран данным элементом.
 CheckAccess	Определяет, имеет ли вызывающий поток доступ к этому объекту DispatcherObject. (Унаследовано от DispatcherObject.)
 ClearValue(DependencyProperty)	Очищает локальное значение свойства. Очищаемое свойство задаётся идентификатором DependencyProperty. (Унаследовано от DependencyObject.)
 ClearValue(DependencyPropertyKey)	Очищает локальное значение свойства, доступного только для чтения. Очищаемое свойство задаётся объектом DependencyPropertyKey. (Унаследовано от DependencyObject.)
 CoerceValue	Осуществляет приведение значения указанного свойства зависимостей. Это достигается путём вызова какой-либо функции CoerceValueCallback, заданной в метаданных свойства зависимости, которое существует в вызывающем объекте DependencyObject. (Унаследовано от DependencyObject.)
 Equals	Определяет, является ли предоставленный объект DependencyObject эквивалентом текущего объекта DependencyObject. (Унаследовано от DependencyObject.)
 Finalize	Позволяет объекту попытаться освободить ресурсы и выполнить другие операции по очистке перед тем, как объект будет утилизирован сборщиком мусора. (Унаследовано от Object.)
 FindCommonVisualAncestor	Возвращает общего предка двух визуальных объектов. (Унаследовано от Visual.)
 Focus	Попытка задать фокус для данного элемента.
 GetAnimationBaseValue	Возвращает базовое значение свойства для заданного свойства этого элемента, игнорируя изменение этого свойства анимацией (запущенной или остановленной).
 GetHashCode	Возвращает хэш-код для данного объекта DependencyObject. (Унаследовано от DependencyObject.)
 GetLayoutClip	Возвращает альтернативную геометрию отсечению, представляющую область, которая будет отсечена в случае задания для свойства ClipToBounds значения true.
 GetLocalValueEnumerator	Создает специализированный перечислитель для указания, какие свойства зависимостей есть локально задать значения для данного DependencyObject. (Унаследовано от DependencyObject.)
 GetType	Возвращает объект класса Type для текущего экземпляра. (Унаследовано от Object.)
 GetUIParentCore	При переопределении в производном классе возвращает альтернативный родительский элемент пользовательский интерфейс при условии отсутствия видимого родительского элемента.
 GetValue	Возвращает текущее действующее значение свойства зависимостей на этом экземпляре a DependencyObject. (Унаследовано от DependencyObject.)
 GetVisualChild	Возвращает указанный объект Visual в родительскую коллекцию VisualCollection. (Унаследовано от Visual.)
 HitTestCore(GeometryHitTestParameters)	Реализует метод Visual.HitTestCore, обеспечивая поведение проверки местонахождения пера для базового элемента (возвращая GeometryHitTestResult). (Переопределяет Visual.HitTestCore(GeometryHitTestParameters).)
 HitTestCore(PointHitTestParameters)	Реализует HitTestCore, обеспечивая поведение проверки местонахождения пера для базового элемента (возвращая HitTestResult). (Переопределяет Visual.HitTestCore(PointHitTestParameters).)
 InputHitTest	Возвращает элемент ввода, расположенный внутри текущего элемента по указанным координатам относительно начала координат текущего элемента.
 InvalidateArrange	Делает недействительным состояние компоновки (структуру) элемента. После этого структура элемента будет обновлена, что произойдет асинхронно, если не сделать это принудительно методом UpdateLayout.
 InvalidateMeasure	Делает недействительным состояние измерения (структуру) элемента.
 InvalidateProperty	Пересчитать действующее значение для указанного свойства зависимостей (Унаследовано от DependencyObject.)
 InvalidateVisual	Делает недействительной отрисовку элемента и принудительно выполняет новый полный проход макета. По завершении цикла макета вызывается метод OnRender.
 IsAncestorOf	Определяет, является ли визуальный объект предком потомка визуального объекта. (Унаследовано от Visual.)
 IsDescendantOf	Определяет, является ли визуальный объект потомком для предка визуального объекта. (Унаследовано от Visual.)
 Measure	Обновляет свойство DesiredSize объекта UIElement. Родительские элементы вызывают данный метод из своих реализаций метода MeasureCore, формируя рекурсивное обновление структуры. Вызов этого метода составляет первый проход (проход измерения) при обновлении структуры.
 MeasureCore	При переопределении в производном классе предоставляет логику измерений для правильного определения размеров данного элемента, с учетом размера каждого из содержащихся в нем дочерних элементов.
 MemberwiseClone	Создает "поверхностную" копию текущего объекта. (Унаследовано от Object.)
 MoveFocus	Предпринимает попытки переместить фокус с данного элемента на иной. Направления для перемещения фокуса задается указанием направления, которое обрабатывается внутри видимого родительского элемента данного элемента.
 OnAccessKey	Предоставляет обработку класса при вызове клавиши доступа, имеющей значение для данного элемента.
 OnChildDesiredSizeChanged	Поддерживает поведение структуры при изменении размеров дочернего элемента.
 OnCreateAutomationPeer	Возвращает определяющиеся классом AutomationPeer реализации для Windows Presentation Foundation (WPF) инфраструктуры.
 OnDragEnter	Вызывается, когда необработанное вложенное событие DragDrop.DragEnter встречает на своем пути элемент, производный от этого класса. Реализуйте этот метод, чтобы добавить для данного события обработчик класса.
 OnDragLeave	Вызывается, когда необработанное вложенное событие DragDrop.DragLeave встречает на своем пути элемент, производный от этого класса. Реализуйте этот метод, чтобы добавить для данного события обработчик класса.
 OnDragOver	Вызывается, когда необработанное вложенное событие DragDrop.DragOver встречает на своем пути элемент, производный от этого класса. Реализуйте этот метод, чтобы добавить для данного события обработчик класса.
 OnDrop	Вызывается, когда необработанное вложенное событие DragDrop.DragEnter встречает на своем пути элемент, производный от этого класса. Реализуйте этот метод, чтобы добавить для данного события обработчик класса.
 OnGiveFeedback	Вызывается, когда необработанное вложенное событие DragDrop.GiveFeedback встречает на своем пути элемент, производный от этого класса. Реализуйте этот метод, чтобы добавить для данного события обработчик класса.
 OnGotFocus	Инициирует перенаправленное событие GotFocus, используя предоставленные данные события.
 OnGotKeyboardFocus	Вызывается, когда необработанное вложенное событие Keyboard.GotKeyboardFocus встречает на своем пути элемент, производный от этого класса. Реализуйте этот метод, чтобы добавить для данного события обработчик класса.
 OnGotMouseCapture	Вызывается, когда необработанное вложенное событие Mouse.GotMouseCapture встречает на своем пути элемент, производный от этого класса. Реализуйте этот метод, чтобы добавить для данного события обработчик класса.
 OnGotStylusCapture	Вызывается, когда необработанное вложенное событие Stylus.GotStylusCapture встречает на своем пути элемент, производный от этого класса. Реализуйте этот метод, чтобы добавить для данного события обработчик класса.
 OnGotTouchCapture	Предоставляет обработку класса для перенаправленного события GotTouchCapture, которое происходит при захвате сенсорного ввода данным элементом.
 OnIsKeyboardFocusedChanged	Вызывается, когда в данном элементе инициируется необработанное событие IsKeyboardFocusedChanged. Реализуйте этот метод, чтобы добавить для данного события обработчик класса.
 OnIsKeyboardFocusWithinChanged	Вызывается непосредственно перед генерацией данным элементом события IsKeyboardFocusWithinChanged. Реализуйте этот метод, чтобы добавить для данного события обработчик класса.
 OnIsMouseCapturedChanged	Вызывается, когда в данном элементе инициируется необработанное событие IsMouseCapturedChanged. Реализуйте этот метод, чтобы добавить для данного события обработчик класса.
 OnIsMouseCaptureWithinChanged	Вызывается, когда в данном элементе инициируется необработанное событие IsMouseCaptureWithinChanged. Реализуйте этот метод, чтобы добавить для данного события обработчик класса.
 OnIsMouseDirectlyOverChanged	Вызывается, когда в данном элементе инициируется необработанное событие IsMouseDirectlyOverChanged. Реализуйте этот метод, чтобы добавить для данного события обработчик класса.
 OnIsStylusCapturedChanged	Вызывается, когда в данном элементе инициируется необработанное событие IsStylusCapturedChanged. Реализуйте этот метод, чтобы добавить для данного события обработчик класса.
 OnIsStylusCaptureWithinChanged	Вызывается, когда в данном элементе инициируется необработанное событие IsStylusCaptureWithinChanged. Реализуйте этот метод, чтобы добавить для данного события обработчик класса.
 OnIsStylusDirectlyOverChanged	Вызывается, когда в данном элементе инициируется необработанное событие IsStylusDirectlyOverChanged. Реализуйте этот метод, чтобы добавить для данного события обработчик класса.
 OnKeyDown	Вызывается, когда необработанное вложенное событие Keyboard.KeyDown встречает на своем пути элемент, производный от этого класса. Реализуйте этот метод, чтобы добавить для данного события обработчик класса.
 OnKeyUp	Вызывается, когда необработанное вложенное событие Keyboard.KeyUp встречает на своем пути элемент, производный от этого класса. Реализуйте этот метод, чтобы добавить для данного события обработчик класса.
 OnLostFocus	Инициирует перенаправленное событие LostFocus, используя предоставленные данные события.
 OnLostKeyboardFocus	Вызывается, когда необработанное вложенное событие Keyboard.LostKeyboardFocus встречает на своем пути элемент, производный от этого класса. Реализуйте этот метод, чтобы добавить для данного события обработчик класса.
 OnLostMouseCapture	Вызывается, когда необработанное вложенное событие Mouse.LostMouseCapture встречает на своем пути элемент, производный от этого класса. Реализуйте этот метод, чтобы добавить для данного события обработчик класса.
 OnLostStylusCapture	Вызывается, когда необработанное вложенное событие Stylus.LostStylusCapture встречает на своем пути элемент, производный от этого класса. Реализуйте этот метод, чтобы добавить для данного события обработчик класса.
 OnLostTouchCapture	Предоставляет обработку класса для перенаправленного события LostTouchCapture, которое происходит при потере захвата сенсорного ввода данным элементом.
 OnManipulationBoundaryFeedback	Вызывается при возникновении события ManipulationBoundaryFeedback.
 OnManipulationCompleted	Вызывается, когда происходит событие ManipulationCompleted.
 OnManipulationDelta	Вызывается, когда происходит событие ManipulationDelta.
 OnManipulationInertiaStarting	Вызывается, когда происходит событие ManipulationInertiaStarting.
 OnManipulationStarted	Вызывается, когда происходит событие ManipulationStarted.
 OnManipulationStarting	Обеспечивает обработку класса для перенаправленного события ManipulationStarting, происходящего при первоначальном создании процессора манипулирования.
 OnMouseDown	Вызывается, когда необработанное вложенное событие Mouse.MouseDown встречает на своем пути элемент, производный от этого класса. Реализуйте этот метод, чтобы добавить для данного события обработчик класса.
 OnMouseEnter	Вызывается при получении данным элементом необработанного вложенного события Mouse.MouseEnter. Реализуйте этот метод, чтобы добавить для данного события обработчик класса.
 OnMouseLeave	Вызывается при получении данным элементом необработанного вложенного события Mouse.MouseLeave. Реализуйте этот метод, чтобы добавить для данного события обработчик класса.
 OnMouseLeftButtonDown	Вызывается, когда в данном элементе инициируется необработанное перенаправленное событие MouseLeftButtonDown. Реализуйте этот метод, чтобы добавить для данного события обработчик класса.
 OnMouseLeftButtonUp	Вызывается, когда необработанное маршрутизируемое событие MouseLeftButtonUp обнаруживает на маршруте элемент, который является производным от данного класса. Реализуйте этот метод, чтобы добавить для данного события обработчик класса.
 OnMouseMove	Вызывается, когда необработанное вложенное событие Mouse.MouseMove встречает на своем пути элемент, производный от этого класса. Реализуйте этот метод, чтобы добавить для данного события обработчик класса.
 OnMouseRightButtonDown	Вызывается, когда необработанное маршрутизируемое событие MouseRightButtonDown обнаруживает на маршруте элемент, который является производным от данного класса. Реализуйте этот метод, чтобы добавить для данного события обработчик класса.
 OnMouseRightButtonUp	Вызывается, когда необработанное маршрутизируемое событие MouseRightButtonUp обнаруживает на маршруте элемент, который является производным от данного класса. Реализуйте этот метод, чтобы добавить для данного события обработчик класса.
 OnMouseUp	Вызывается, когда необработанное маршрутизируемое событие Mouse.MouseUp обнаруживает на маршруте элемент, который является производным от данного класса. Реализуйте этот метод, чтобы добавить для данного события обработчик класса.
 OnMouseWheel	Вызывается, когда необработанное вложенное событие Mouse.MouseWheel встречает на своем пути элемент, производный от этого класса. Реализуйте этот метод, чтобы добавить для данного события обработчик класса.
 OnPreviewDragEnter	Вызывается, когда необработанное вложенное событие DragDrop.PreviewDragEnter встречает на своем пути элемент, производный от этого класса. Реализуйте этот метод, чтобы добавить для данного события обработчик класса.
 OnPreviewDragLeave	Вызывается, когда необработанное вложенное событие DragDrop.PreviewDragLeave встречает на своем пути элемент, производный от этого класса. Реализуйте этот метод, чтобы добавить для данного события обработчик класса.
 OnPreviewDragOver	Вызывается, когда необработанное вложенное событие DragDrop.PreviewDragOver встречает на своем пути элемент, производный от этого класса. Реализуйте этот метод, чтобы добавить для данного события обработчик класса.
 OnPreviewDrop	Вызывается, когда необработанное вложенное событие DragDrop.PreviewDrop встречает на своем пути элемент, производный от этого класса. Реализуйте этот метод, чтобы добавить для данного события обработчик класса.
 OnPreviewGiveFeedback	Вызывается, когда необработанное вложенное событие DragDrop.PreviewGiveFeedback встречает на своем пути элемент, производный от этого класса. Реализуйте этот метод, чтобы добавить для данного события обработчик класса.
 OnPreviewGotKeyboardFocus	Вызывается, когда необработанное вложенное событие Keyboard.PreviewGotKeyboardFocus встречает на своем пути элемент, производный от этого класса. Реализуйте этот метод, чтобы добавить для данного события обработчик класса.
 OnPreviewKeyDown	Вызывается, когда необработанное вложенное событие Keyboard.PreviewKeyDown встречает на своем пути элемент, производный от этого класса. Реализуйте этот метод, чтобы добавить для данного события обработчик класса.
 OnPreviewKeyUp	Вызывается, когда необработанное вложенное событие Keyboard.PreviewKeyUp встречает на своем пути элемент, производный от этого класса. Реализуйте этот метод, чтобы добавить для данного события обработчик класса.
 OnPreviewLostKeyboardFocus	Вызывается, когда необработанное вложенное событие Keyboard.PreviewKeyDown встречает на своем пути элемент, производный от этого класса. Реализуйте этот метод, чтобы добавить для данного события обработчик класса.
 OnPreviewMouseDown	Вызывается, когда необработанное вложенное маршрутизированное событие Mouse.PreviewMouseDown достигает на своем пути элемента, производного от этого класса. Реализуйте этот метод, чтобы добавить для данного события обработчик класса.
 OnPreviewMouseLeftButtonDown	Вызывается, когда необработанное маршрутизируемое событие PreviewMouseLeftButtonDown обнаруживает на маршруте элемент, который является производным от данного класса. Реализуйте этот метод, чтобы добавить для данного события обработчик класса.
 OnPreviewMouseLeftButtonUp	Вызывается, когда необработанное маршрутизируемое событие PreviewMouseLeftButtonUp обнаруживает на маршруте элемент, который является производным от данного класса. Реализуйте этот метод, чтобы добавить для данного события обработчик класса.
 OnPreviewMouseMove	Вызывается, когда необработанное вложенное событие Mouse.PreviewMouseMove встречает на своем пути элемент, производный от этого класса. Реализуйте этот метод, чтобы добавить для данного события обработчик класса.
 OnPreviewMouseRightButtonDown	Вызывается, когда необработанное маршрутизируемое событие PreviewMouseRightButtonDown обнаруживает на маршруте элемент, который является производным от данного класса. Реализуйте этот метод, чтобы добавить для данного события обработчик класса.
 OnPreviewMouseRightButtonUp	Вызывается, когда необработанное маршрутизируемое событие PreviewMouseRightButtonUp обнаруживает на маршруте элемент, который является производным от данного класса. Реализуйте этот метод, чтобы добавить для данного события обработчик класса.
 OnPreviewMouseUp	Вызывается, когда необработанное вложенное событие Mouse.PreviewMouseUp встречает на своем пути элемент, производный от этого класса. Реализуйте этот метод, чтобы добавить для данного события обработчик класса.
 OnPreviewMouseWheel	Вызывается, когда необработанное вложенное событие Mouse.PreviewMouseWheel встречает на своем пути элемент, производный от этого класса. Реализуйте этот метод, чтобы добавить для данного события обработчик класса.
 OnPreviewQueryContinueDrag	Вызывается, когда необработанное вложенное событие DragDrop.PreviewQueryContinueDrag встречает на своем пути элемент, производный от этого класса. Реализуйте этот метод, чтобы добавить для данного события обработчик класса.
 OnPreviewStylusButtonDown	Вызывается, когда необработанное вложенное событие Stylus.PreviewStylusButtonDown встречает на своем пути элемент, производный от этого класса. Реализуйте этот метод, чтобы добавить для данного события обработчик класса.
 OnPreviewStylusButtonUp	Вызывается, когда необработанное вложенное событие Stylus.PreviewStylusButtonUp встречает на своем пути элемент, производный от этого класса. Реализуйте этот метод, чтобы добавить для данного события обработчик класса.
 OnPreviewStylusDown	Вызывается, когда необработанное вложенное событие Stylus.PreviewStylusDown встречает на своем пути элемент, производный от этого класса. Реализуйте этот метод, чтобы добавить для данного события обработчик класса.
 OnPreviewStylusInAirMove	Вызывается, когда необработанное вложенное событие Stylus.PreviewStylusInAirMove встречает на своем пути элемент, производный от этого класса. Реализуйте этот метод, чтобы добавить для данного события обработчик класса.
 OnPreviewStylusInRange	Вызывается, когда необработанное вложенное событие Stylus.PreviewStylusInRange встречает на своем пути элемент, производный от этого класса. Реализуйте этот метод, чтобы добавить для данного события обработчик класса.
 OnPreviewStylusMove	Вызывается, когда необработанное вложенное событие Stylus.PreviewStylusMove встречает на своем пути элемент, производный от этого класса. Реализуйте этот метод, чтобы добавить для данного события обработчик класса.
 OnPreviewStylusOutOfRange	Вызывается, когда необработанное вложенное событие Stylus.PreviewStylusOutOfRange встречает на своем пути элемент, производный от этого класса. Реализуйте этот метод, чтобы добавить для данного события обработчик класса.
 OnPreviewStylusSystemGesture	Вызывается, когда необработанное вложенное событие Stylus.PreviewStylusSystemGesture встречает на своем пути элемент, производный от этого класса. Реализуйте этот метод, чтобы добавить для данного события обработчик класса.
 OnPreviewStylusUp	Вызывается, когда необработанное вложенное событие Stylus.PreviewStylusUp встречает на своем пути элемент, производный от этого класса. Реализуйте этот метод, чтобы добавить для данного события обработчик класса.
 OnPreviewTextInput	Вызывается, когда необработанное вложенное событие TextCompositionManager.PreviewTextInput встречает на своем пути элемент, производный от этого класса. Реализуйте этот метод, чтобы добавить для данного события обработчик класса.
 OnPreviewTouchDown	Предоставляет обработку класса для перенаправленного события PreviewTouchDown, которое происходит при сенсорном нажатии данного элемента.
 OnPreviewTouchMove	Предоставляет обработку класса для маршрутизируемого события PreviewTouchMove, которое происходит при перемещении касания внутри этого элемента.
 OnPreviewTouchUp	Предоставляет обработку класса для перенаправленного события PreviewTouchUp, которое происходит при прекращении сенсорного нажатия внутри элемента.
 OnPropertyChanged	Вызывается, когда действующего значения любых свойства зависимостей в этом DependencyObject обновление. Определенный свойством зависимостей, которое изменилось в данных события. (Унаследовано от DependencyObject.)
 OnQueryContinueDrag	Вызывается, когда необработанное вложенное событие DragDrop.QueryContinueDrag встречает на своем пути элемент, производный от этого класса. Реализуйте этот метод, чтобы добавить для данного события обработчик класса.
 OnQueryCursor	Вызывается, когда необработанное вложенное событие Mouse.QueryCursor встречает на своем пути элемент, производный от этого класса. Реализуйте этот метод, чтобы добавить для данного события обработчик класса.
 OnRender	При переопределении в производном классе участвует в операциях отрисовки, направляемых системой структуры. Инструкции отрисовки для данного элемента не используются непосредственно при вызове данного метода, а вместо этого сохраняются для последующего асинхронного использования при структурировании и рисовании.
 OnRenderSizeChanged	При переопределении в производном классе участвует в операциях отрисовки, направляемых системой структуры. Данный метод вызывается после обновления структуры и перед отрисовкой, если свойство RenderSize элемента было изменено в результате обновления структуры.
 OnStylusButtonDown	Вызывается, когда необработанное вложенное событие Stylus.StylusButtonDown встречает на своем пути элемент, производный от этого класса. Реализуйте этот метод, чтобы добавить для данного события обработчик класса.
 OnStylusButtonUp	Вызывается, когда необработанное вложенное событие Stylus.StylusButtonUp встречает на своем пути элемент, производный от этого класса. Реализуйте этот метод, чтобы добавить для данного события обработчик класса.
 OnStylusDown	Вызывается, когда необработанное вложенное событие Stylus.StylusDown встречает на своем пути элемент, производный от этого класса. Реализуйте этот метод, чтобы добавить для данного события обработчик класса.
 OnStylusEnter	Вызывается при получении данным элементом необработанного вложенного события Stylus.StylusEnter. Реализуйте этот метод, чтобы добавить для данного события обработчик класса.
 OnStylusInAirMove	Вызывается, когда необработанное вложенное событие Stylus.StylusInAirMove встречает на своем пути элемент, производный от этого класса. Реализуйте этот метод, чтобы добавить для данного события обработчик класса.
 OnStylusInRange	Вызывается, когда необработанное вложенное событие Stylus.StylusInRange встречает на своем пути элемент, производный от этого класса. Реализуйте этот метод, чтобы добавить для данного события обработчик класса.
 OnStylusLeave	Вызывается при получении данным элементом необработанного вложенного события Stylus.StylusLeave. Реализуйте этот метод, чтобы добавить для данного события обработчик класса.
 OnStylusMove	Вызывается, когда необработанное вложенное событие Stylus.StylusMove встречает на своем пути элемент, производный от этого класса. Реализуйте этот метод, чтобы добавить для данного события обработчик класса.
 OnStylusOutOfRange	Вызывается, когда необработанное вложенное событие Stylus.StylusOutOfRange встречает на своем пути элемент, производный от этого класса. Реализуйте этот метод, чтобы добавить для данного события обработчик класса.
 OnStylusSystemGesture	Вызывается, когда необработанное вложенное событие Stylus.StylusSystemGesture встречает на своем пути элемент, производный от этого класса. Реализуйте этот метод, чтобы добавить для данного события обработчик класса.
 OnStylusUp	Вызывается, когда необработанное вложенное событие Stylus.StylusUp встречает на своем пути элемент, производный от этого класса. Реализуйте этот метод, чтобы добавить для данного события обработчик класса.
 OnTextInput	Вызывается, когда необработанное вложенное событие TextCompositionManager.TextInput встречает на своем пути элемент, производный от этого класса. Реализуйте этот метод, чтобы добавить для данного события обработчик класса.
 OnTouchDown	Предоставляет обработку класса для перенаправленного события TouchDown, которое происходит при сенсорном нажатии внутри данного элемента.
 OnTouchEnter	Предоставляет обработку класса для перенаправленного события TouchEnter, которое происходит при сенсорном перемещении внутрь данного элемента.
 OnTouchLeave	Предоставляет обработку класса для перенаправленного события TouchLeave, которое происходит при сенсорном перемещении из данного элемента UIElement за его пределы.
 OnTouchMove	Предоставляет обработку класса для перенаправленного события TouchMove, которое происходит при перемещении касания внутри этого элемента.
 OnTouchUp	Предоставляет обработку класса для перенаправленного события TouchUp, которое происходит при прекращении сенсорного нажатия внутри элемента.
 OnVisualChildrenChanged	Вызывается, если коллекция VisualCollection визуального объекта изменяется. (Унаследовано от Visual.)
 OnVisualParentChanged	Вызывается, когда родительский элемент данного UIElement сообщает об изменении в его базовом визуальном родителе. (Переопределяет Visual.OnVisualParentChanged(DependencyObject).)
 PointFromScreen	Преобразовывает объект Point в экранных координатах в объект Point, представляющий текущую систему координат Visual. (Унаследовано от Visual.)
 PointToScreen	Преобразовывает объект Point, представляющий текущую систему координат объекта Visual, в объект Point в экранных координатах. (Унаследовано от Visual.)
 PredictFocus	При переопределении в производном классе возвращает элемент, который должен получить фокус для указанного направления перемещения фокуса без перемещения фокуса на этот элемент.
 RaiseEvent	Генерирует указанное перенаправленное событие. RoutedEvent , которое должно быть идентифицировано в предоставленном экземпляре RoutedEventArgs (как и свойство RoutedEvent данных события).
 ReadLocalValue	Возвращает локальное значение свойства зависимостей, если оно существует. (Унаследовано от DependencyObject.)
 ReleaseAllTouchCaptures	Освобождает все полученные сенсорные устройства для данного элемента.
 ReleaseMouseCapture	Освобождает мышь, если элемент произвел ее захват.
 ReleaseStylusCapture	Освобождает перо, если элемент произвел его захват.
 ReleaseTouchCapture	Предпринимает попытку освободить заданное сенсорное устройство из этого элемента.
 RemoveHandler	Удаляет из данного элемента указанный обработчик маршрутизируемого события.
 RemoveVisualChild	Удаляет связь "родитель-потомок" между двумя визуальными объектами. (Унаследовано от Visual.)
 SetCurrentValue	Устанавливает значение свойства зависимостей без изменения его источник значения. (Унаследовано от DependencyObject.)
 SetValue(DependencyProperty, Object)	Задает локальное значение свойства зависимостей, определяемое по его идентификатору свойства зависимостей. (Унаследовано от DependencyObject.)
 SetValue(DependencyPropertyKey, Object)	Задает локальное значение доступного только для чтения свойства зависимостей, указанного идентификатором DependencyPropertyKey . (Унаследовано от DependencyObject.)
 ShouldSerializeCommandBindings	Возвращает логическое значение, указывающее, следует ли процессам сериализации сериализировать содержимое свойства CommandBindings в экземплярах данного класса.
 ShouldSerializeInputBindings	Возвращает логическое значение, указывающее, следует ли процессам сериализации сериализировать содержимое свойства InputBindings в экземплярах данного класса.
 ShouldSerializeProperty	Возвращает значение, указывающее, должны ли процессы сериализации сериализовать значение, предоставленное свойства зависимостей. (Унаследовано от DependencyObject.)
 ToString	Возвращает строковое представление текущего объекта.(Унаследовано от Object.)
 TransformToAncestor(Visual)	Возвращает преобразование, которое может использоваться для преобразования координат этого объекта Visual в координаты заданного предка визуального объекта Visual. (Унаследовано от Visual.)
 TransformToAncestor(Visual3D)	Возвращает преобразование, которое может использоваться для преобразования координат этого объекта Visual в координаты заданного предка визуального объекта Visual3D. (Унаследовано от Visual.)
 TransformToDescendant	Возвращает преобразование, которое может использоваться для преобразования координат этого объекта Visual в координаты заданного потомка визуального объекта. (Унаследовано от Visual.)
 TransformToVisual	Возвращает преобразование, которое может использоваться для преобразования координат этого объекта Visual в координаты заданного визуального объекта. (Унаследовано от Visual.)
 TranslatePoint	Преобразует точку относительно данного элемента в координаты относительно указанного элемента.
 UpdateLayout	Обеспечивает правильное обновление всех визуальных дочерних элементов данного элемента для структуры.
 VerifyAccess	Обеспечивает нахождение вызывающий поток имеет доступ к данному DispatcherObject. (Унаследовано от DispatcherObject.)

События

 DragEnter	Возникает, когда система ввода сообщает о возникновении базового события перетаскивания, в котором этот элемент является местом назначения для перетаскивания
 DragLeave	Возникает, когда система ввода сообщает о возникновении базового события перетаскивания, в котором этот элемент является пунктом отправления для перетаскивания.
 DragOver	Возникает, когда система ввода сообщает о возникновении базового события перетаскивания, в котором этот элемент является потенциальным местом назначения для отпускания.
 Drop	Возникает, когда система ввода сообщает о возникновении базового события перетаскивания, в котором этот элемент является местом назначения для отпускания. 
 FocusableChanged	Возникает при изменении значения свойства Focusable
 GiveFeedback	Возникает, когда система ввода сообщает о возникновении базового события перетаскивания, в котором участвует данный элемент. 
 GotFocus	Возникает, когда элемент получает логический фокус.
 GotKeyboardFocus	Возникает, когда фокус клавиатуры установлен на этом элементе.
 GotMouseCapture	Возникает, когда данный элемент захватывает мышь.
 GotStylusCapture	Возникает, когда данный элемент захватывает перо.
 GotTouchCapture	Возникает, когда данный элемент захватывает устройство сенсорного ввода.
 IsEnabledChanged	Возникает при изменении значения свойства IsEnabled данного элемента.
 IsHitTestVisibleChanged	Возникает при изменении в этом элементе значения свойства зависимостей IsHitTestVisible.
 IsKeyboardFocusedChanged	Возникает при изменениив этом элементе значения свойства IsKeyboardFocused.
 IsKeyboardFocusWithinChanged	Возникает при изменении в этом элементе значения свойства IsKeyboardFocusWithinChanged.
 IsMouseCapturedChanged	Возникает при изменении в этом элементе значения свойства IsMouseCaptured.
 IsMouseCaptureWithinChanged	Возникает при изменении в этом элементе значения свойства IsMouseCaptureWithinProperty.
 IsMouseDirectlyOverChanged	Возникает при изменении в этом элементе значения свойства IsMouseDirectlyOver.
 IsStylusCapturedChanged	Возникает при изменении в этом элементе значения свойства IsStylusCaptured.
 IsStylusCaptureWithinChanged	Возникает при изменении в этом элементе значения свойства IsStylusCaptureWithin.
 IsStylusDirectlyOverChanged	Возникает при изменении в этом элементе значения свойства IsStylusDirectlyOver.
 IsVisibleChanged	Возникает при изменении в этом элементе значения свойства IsVisible.
 KeyDown	Возникает при нажатии клавиши, если этот элемент имеет фокус.
 KeyUp	Возникает при отжатии клавиши, если этот элемент имеет фокус.
 LayoutUpdated	Возникает при изменении структуры различных визуальных элементов, связанных с текущим объектом Dispatcher.
 LostFocus	Возникает, когда данный элемент теряет логический фокус.
 LostKeyboardFocus	Возникает, когда фокус клавиатуры перестаёт быть установленным на этом элементе.
 LostMouseCapture	Возникает, когда данный элемент теряет захват мыши.
 LostStylusCapture	Возникает, когда данный элемент теряет захват пера.
 LostTouchCapture	Возникает, когда данный элемент теряет захват устройства сенсорного ввода.
 ManipulationBoundaryFeedback	Возникает, когда манипуляция наталкивается на границу.
 ManipulationCompleted	Возникает при завершении для объекта UIElement процессов манипуляции и инерции.
 ManipulationDelta	Возникает, когда устройство ввода меняет положение в процессе манипуляции.
 ManipulationInertiaStarting	Возникает, когда устройство ввода теряет контакт с объектом UIElement в процессе манипуляции, и начинается процесс инерции.
 ManipulationStarted	Возникает, когда устройство ввода начинает процесс манипуляции для объекта UIElement
 ManipulationStarting	Возникает при первом создании процессора манипуляции.
 MouseDown	Возникает при нажатии любой кнопки мыши при условии, если указатель мыши находится над этим элементом.
 MouseEnter	Возникает, когда указатель мыши входит в границы этого элемента.
 MouseLeave	Возникает, когда указатель мыши покидает границы этого элемента.
 MouseLeftButtonDown	Возникает при нажатии левой кнопки мыши при условии, если указатель мыши находится над этим элементом.
 MouseLeftButtonUp	Возникает при отпускании левой кнопки мыши при условии, если указатель мыши находится над этим элементом.
 MouseMove	Возникает, когда указатель мыши перемещается над этим элементом.
 MouseRightButtonDown	Возникает при нажатии правой кнопки мыши при условии, если указатель мыши находится над этим элементом.
 MouseRightButtonUp	Возникает при отпускании правой кнопки мыши при условии, если указатель мыши находится над этим элементом.
 MouseUp	Возникает при отпускании любой кнопки мыши над этим элементом.
 MouseWheel	Возникает, когда пользователь вращает колёсико мыши при условии, если указатель мыши находится над этим элементом.
 PreviewDragEnter	Возникает, когда система ввода сообщает о возникновении базового события перетаскивания, в котором этот элемент является местом назначения для перетаскивания
 PreviewDragLeave	Возникает, когда система ввода сообщает о возникновении базового события перетаскивания, в котором этот элемент является пунктом отправления для перетаскивания.
 PreviewDragOver	Возникает, когда система ввода сообщает о возникновении базового события перетаскивания, в котором этот элемент является потенциальным местом назначения для отпускания.
 PreviewDrop	Возникает, когда система ввода сообщает о возникновении базового события перетаскивания, в котором этот элемент является местом назначения для отпускания. 
 PreviewGiveFeedback	Возникает, когда начинается операция перетаскивания.
 PreviewGotKeyboardFocus	Возникает, когда фокус клавиатуры установлен на этом элементе.
 PreviewKeyDown	Возникает при нажатии клавиши, если этот элемент имеет фокус.
 PreviewKeyUp	Возникает при отжатии клавиши, если этот элемент имеет фокус.
 PreviewLostKeyboardFocus	Возникает, когда фокус клавиатуры перестаёт быть установленным на этом элементе.
 PreviewMouseDown	Возникает при нажатии любой кнопки мыши при условии, если указатель мыши находится над этим элементом.
 PreviewMouseLeftButtonDown	Возникает при нажатии левой кнопки мыши при условии, если указатель мыши находится над этим элементом.
 PreviewMouseLeftButtonUp	Возникает при отпускании левой кнопки мыши при условии, если указатель мыши находится над этим элементом.
 PreviewMouseMove	Возникает, при перемещении указателя мыши во время нахождения указателя мыши над этим элементом.
 PreviewMouseRightButtonDown	Возникает при нажатии правой кнопки мыши при условии, если указатель мыши находится над этим элементом.
 PreviewMouseRightButtonUp	Возникает при отпускании правой кнопки мыши при условии, если указатель мыши находится над этим элементом.
 PreviewMouseUp	Возникает при отпускании любой кнопки мыши при условии, если указатель мыши находится над этим элементом.
 PreviewMouseWheel	Возникает, когда пользователь вращает колёсико мыши при условии, если указатель мыши находится над этим элементом.
 PreviewQueryContinueDrag	Возникает при изменении состояния клавиатуры или кнопки мыши во время операции перетаскивания.
 PreviewStylusButtonDown	Возникает при нажатии кнопки пера при условии при условии, если указатель находится над этим элементом.
 PreviewStylusButtonUp	Возникает при отпускании кнопки пера при условии, если указатель находится над этим элементом.
 PreviewStylusDown	Возникает при касании пером дигитайзера во время его нахождения над этим элементом.
 PreviewStylusInAirMove	Возникает при перемещении пера над элементом без соприкосновения с дигитайзером.
 PreviewStylusInRange	Возникает, когда перо находится достаточно близко к дигитайзеру, чтобы быть обнаруженным, при условии, если указатель находится над этим элементом.
 PreviewStylusMove	Возникает при перемещении пера над элементом. Чтобы возникло данное событие, перо должно перемещаться, будучи обнаруженным дигитайзером, в противном случае возникает событие PreviewStylusInAirMove.
 PreviewStylusOutOfRange	Возникает, когда перо находится слишком далеко от дигитайзера, чтобы быть обнаруженным.
 PreviewStylusSystemGesture	Возникает, когда пользователь воспроизводит один из нескольких жестов пера.
 PreviewStylusUp	Возникает, когда пользователь отрывает перо от дигитайзера при условии, если указатель находится над этим элементом.
 PreviewTextInput	Возникает, когда данный элемент получает текст аппаратно-независимым образом. (То есть возникновение события не зависит от того, при помощи какого устройства текст был введён в элемент).
 PreviewTouchDown	Возникает, когда палец касается экрана при условии, если палец находится над этим элементом.
 PreviewTouchMove	Возникает при перемещении пальца по экрану при условии, если палец находится над этим элементом.
 PreviewTouchUp	Возникает, когда палец отрывается от экрана при условии, если палец находится над этим элементом.
 QueryContinueDrag	Возникает при изменении состояния клавиатуры или кнопки мыши во время операции перетаскивания.
 QueryCursor	Возникает при получении запроса отображения курсора. Это событие инициируется при каждом изменении положения указателя мыши на элементе, что означает возможную необходимость изменения объекта курсора в связи с его новым положением.
 StylusButtonDown	Возникает при нажатии кнопки пера при условии при условии, если указатель находится над этим элементом.
 StylusButtonUp	Возникает при отпускании кнопки пера при условии, если указатель находится над этим элементом.
 StylusDown	Возникает при касании пером дигитайзера при условии, если перо находится над этим элементом.
 StylusEnter	Возникает, когда перо входит в границы этого элемента.
 StylusInAirMove	Возникает при перемещении пера над элементом без соприкосновения с дигитайзером.
 StylusInRange	Возникает, когда перо находится достаточно близко к дигитайзеру, чтобы быть обнаруженным, при условии, если указатель находится над этим элементом.
 StylusLeave	Возникает, когда перо покидает границы этого элемента.
 StylusMove	Возникает при перемещении пера над этим элементом. Чтобы возникло данное событие, перо должно перемещаться, находясь на дигитайзере. В противном случае вместо него возникает событие StylusInAirMove.
 StylusOutOfRange	Возникает, когда перо, располагаясь над этим элементом, находится слишком далеко от дигитайзера, чтобы быть обнаруженным.
 StylusSystemGesture	Возникает, когда пользователь воспроизводит один из нескольких жестов пера.
 StylusUp	Возникает, когда пользователь отрывает перо от дигитайзера при условии, если указатель находится над этим элементом.
 TextInput	Возникает, когда данный элемент получает текст аппаратно-независимым образом. (То есть возникновение события не зависит от того, при помощи какого устройства текст был введён в элемент).
 TouchDown	Возникает, когда палец касается экрана при условии, если палец находится над этим элементом.
 TouchEnter	Происходит при перемещении касания через границы этого элемента снаружи вовнутрь.
 TouchLeave	Происходит при перемещении касания через границы этого элемента изнутри наружу.
 TouchMove	Возникает при перемещении пальца по экрану при условии, если палец находится над этим элементом.
 TouchUp	Возникает, когда палец отрывается от экрана при условии, если палец находится над этим элементом.

Статические поля

 AllowDropProperty	Идентифицирует свойство зависимостей AllowDrop.
 AreAnyTouchesCapturedProperty	Определяет свойство зависимостей AreAnyTouchesCaptured.
 AreAnyTouchesCapturedWithinProperty	Определяет свойство зависимостей AreAnyTouchesCapturedWithin.
 AreAnyTouchesDirectlyOverProperty	Определяет свойство зависимостей AreAnyTouchesDirectlyOver.
 AreAnyTouchesOverProperty	Определяет свойство зависимостей AreAnyTouchesOver.
 BitmapEffectInputProperty	Идентифицирует свойство зависимостей BitmapEffectInput.
 BitmapEffectProperty	Идентифицирует свойство зависимостей BitmapEffect.
 CacheModeProperty	Определяет свойство зависимостей CacheMode.
 ClipProperty	Идентифицирует свойство зависимостей Clip.
 ClipToBoundsProperty	Идентифицирует свойство зависимостей ClipToBounds.
 DragEnterEvent	Идентифицирует перенаправленное событие DragEnter.
 DragLeaveEvent	Идентифицирует перенаправленное событие DragLeave.
 DragOverEvent	Идентифицирует перенаправленное событие DragOver.
 DropEvent	Идентифицирует перенаправленное событие Drop.
 EffectProperty	Определяет свойство зависимостей Effect.
 FocusableProperty	Идентифицирует свойство зависимостей Focusable.
 GiveFeedbackEvent	Идентифицирует перенаправленное событие GiveFeedback.
 GotFocusEvent	Идентифицирует перенаправленное событие GotFocus.
 GotKeyboardFocusEvent	Идентифицирует перенаправленное событие GotKeyboardFocus.
 GotMouseCaptureEvent	Идентифицирует перенаправленное событие GotMouseCapture.
 GotStylusCaptureEvent	Идентифицирует перенаправленное событие GotStylusCapture.
 GotTouchCaptureEvent	Определяет перенаправленное событие GotTouchCapture.
 IsEnabledProperty	Идентифицирует свойство зависимостей IsEnabled.
 IsFocusedProperty	Идентифицирует свойство зависимостей IsFocused.
 IsHitTestVisibleProperty	Определяет свойство зависимостей IsHitTestVisible  свойство зависимости.
 IsKeyboardFocusedProperty	Идентифицирует свойство зависимостей IsKeyboardFocused.
 IsKeyboardFocusWithinProperty	Идентифицирует свойство зависимостей IsKeyboardFocusWithin.
 IsManipulationEnabledProperty	Определяет свойство зависимостей IsManipulationEnabled.
 IsMouseCapturedProperty	Идентифицирует свойство зависимостей IsMouseCaptured.
 IsMouseCaptureWithinProperty	Идентифицирует свойство зависимостей IsMouseCaptureWithin.
 IsMouseDirectlyOverProperty	Идентифицирует свойство зависимостей IsMouseDirectlyOver.
 IsMouseOverProperty	Идентифицирует свойство зависимостей IsMouseOver.
 IsStylusCapturedProperty	Идентифицирует свойство зависимостей IsStylusCaptured.
 IsStylusCaptureWithinProperty	Идентифицирует свойство зависимостей IsStylusCaptureWithin.
 IsStylusDirectlyOverProperty	Идентифицирует свойство зависимостей IsStylusDirectlyOver.
 IsStylusOverProperty	Идентифицирует свойство зависимостей IsStylusOver.
 IsVisibleProperty	Идентифицирует свойство зависимостей IsVisible.
 KeyDownEvent	Идентифицирует перенаправленное событие KeyDown.
 KeyUpEvent	Идентифицирует перенаправленное событие KeyUp.
 LostFocusEvent	Идентифицирует перенаправленное событие LostFocus.
 LostKeyboardFocusEvent	Идентифицирует перенаправленное событие LostKeyboardFocus.
 LostMouseCaptureEvent	Идентифицирует перенаправленное событие LostMouseCapture.
 LostStylusCaptureEvent	Идентифицирует перенаправленное событие LostStylusCapture.
 LostTouchCaptureEvent	Определяет перенаправленное событие LostTouchCapture.
 ManipulationBoundaryFeedbackEvent	Определяет событие ManipulationBoundaryFeedback.
 ManipulationCompletedEvent	Идентифицирует перенаправленное событие ManipulationCompleted.
 ManipulationDeltaEvent	Идентифицирует перенаправленное событие ManipulationDelta.
 ManipulationInertiaStartingEvent	Идентифицирует перенаправленное событие ManipulationInertiaStarting.
 ManipulationStartedEvent	Идентифицирует перенаправленное событие ManipulationStarted.
 ManipulationStartingEvent	Определяет перенаправленное событие ManipulationStarting.
 MouseDownEvent	Идентифицирует перенаправленное событие MouseDown.
 MouseEnterEvent	Идентифицирует перенаправленное событие MouseEnter.
 MouseLeaveEvent	Идентифицирует перенаправленное событие MouseLeave.
 MouseLeftButtonDownEvent	Идентифицирует перенаправленное событие MouseLeftButtonDown.
 MouseLeftButtonUpEvent	Идентифицирует перенаправленное событие MouseLeftButtonUp.
 MouseMoveEvent	Идентифицирует перенаправленное событие MouseMove.
 MouseRightButtonDownEvent	Идентифицирует перенаправленное событие MouseRightButtonDown.
 MouseRightButtonUpEvent	Идентифицирует перенаправленное событие MouseRightButtonUp.
 MouseUpEvent	Идентифицирует перенаправленное событие MouseUp.
 MouseWheelEvent	Идентифицирует перенаправленное событие MouseWheel.
 OpacityMaskProperty	Идентифицирует свойство зависимостей OpacityMask.
 OpacityProperty	Идентифицирует свойство зависимостей Opacity.
 PreviewDragEnterEvent	Идентифицирует перенаправленное событие PreviewDragEnter.
 PreviewDragLeaveEvent	Идентифицирует перенаправленное событие PreviewDragLeave.
 PreviewDragOverEvent	Идентифицирует перенаправленное событие PreviewDragOver.
 PreviewDropEvent	Идентифицирует перенаправленное событие PreviewDrop.
 PreviewGiveFeedbackEvent	Идентифицирует перенаправленное событие PreviewGiveFeedback.
 PreviewGotKeyboardFocusEvent	Идентифицирует перенаправленное событие PreviewGotKeyboardFocus.
 PreviewKeyDownEvent	Идентифицирует перенаправленное событие PreviewKeyDown.
 PreviewKeyUpEvent	Идентифицирует перенаправленное событие PreviewKeyUp.
 PreviewLostKeyboardFocusEvent	Идентифицирует перенаправленное событие PreviewLostKeyboardFocus.
 PreviewMouseDownEvent	Идентифицирует перенаправленное событие PreviewMouseDown.
 PreviewMouseLeftButtonDownEvent	Идентифицирует перенаправленное событие PreviewMouseLeftButtonDown.
 PreviewMouseLeftButtonUpEvent	Идентифицирует перенаправленное событие PreviewMouseLeftButtonUp.
 PreviewMouseMoveEvent	Идентифицирует перенаправленное событие PreviewMouseMove.
 PreviewMouseRightButtonDownEvent	Идентифицирует перенаправленное событие PreviewMouseRightButtonDown.
 PreviewMouseRightButtonUpEvent	Идентифицирует перенаправленное событие PreviewMouseRightButtonUp.
 PreviewMouseUpEvent	Идентифицирует перенаправленное событие PreviewMouseUp.
 PreviewMouseWheelEvent	Идентифицирует перенаправленное событие PreviewMouseWheel.
 PreviewQueryContinueDragEvent	Идентифицирует перенаправленное событие PreviewQueryContinueDrag.
 PreviewStylusButtonDownEvent	Идентифицирует перенаправленное событие PreviewStylusButtonDown.
 PreviewStylusButtonUpEvent	Идентифицирует перенаправленное событие PreviewStylusButtonUp.
 PreviewStylusDownEvent	Идентифицирует перенаправленное событие PreviewStylusDown.
 PreviewStylusInAirMoveEvent	Идентифицирует перенаправленное событие PreviewStylusInAirMove.
 PreviewStylusInRangeEvent	Идентифицирует перенаправленное событие PreviewStylusInRange.
 PreviewStylusMoveEvent	Идентифицирует перенаправленное событие PreviewStylusMove.
 PreviewStylusOutOfRangeEvent	Идентифицирует перенаправленное событие PreviewStylusOutOfRange.
 PreviewStylusSystemGestureEvent	Идентифицирует перенаправленное событие PreviewStylusSystemGesture.
 PreviewStylusUpEvent	Идентифицирует перенаправленное событие PreviewStylusUp.
 PreviewTextInputEvent	Идентифицирует перенаправленное событие PreviewTextInput.
 PreviewTouchDownEvent	Определяет перенаправленное событие PreviewTouchDown.
 PreviewTouchMoveEvent	Определяет перенаправленное событие PreviewTouchMove.
 PreviewTouchUpEvent	Определяет перенаправленное событие PreviewTouchUp.
 QueryContinueDragEvent	Идентифицирует перенаправленное событие QueryContinueDrag.
 QueryCursorEvent	Идентифицирует перенаправленное событие QueryCursor.
 RenderTransformOriginProperty	Идентифицирует свойство зависимостей RenderTransformOrigin.
 RenderTransformProperty	Идентифицирует свойство зависимостей RenderTransform.
 SnapsToDevicePixelsProperty	Идентифицирует свойство зависимостей SnapsToDevicePixels.
 StylusButtonDownEvent	Идентифицирует перенаправленное событие StylusButtonDown.
 StylusButtonUpEvent	Идентифицирует перенаправленное событие StylusButtonUp.
 StylusDownEvent	Идентифицирует перенаправленное событие StylusDown.
 StylusEnterEvent	Идентифицирует перенаправленное событие StylusEnter.
 StylusInAirMoveEvent	Идентифицирует перенаправленное событие StylusInAirMove.
 StylusInRangeEvent	Идентифицирует перенаправленное событие StylusInRange.
 StylusLeaveEvent	Идентифицирует перенаправленное событие StylusLeave.
 StylusMoveEvent	Идентифицирует перенаправленное событие StylusMove.
 StylusOutOfRangeEvent	Идентифицирует перенаправленное событие StylusOutOfRange.
 StylusSystemGestureEvent	Идентифицирует перенаправленное событие StylusSystemGesture.
 StylusUpEvent	Идентифицирует перенаправленное событие StylusUp.
 TextInputEvent	Идентифицирует перенаправленное событие TextInput.
 TouchDownEvent	Определяет перенаправленное событие TouchDown.
 TouchEnterEvent	Определяет перенаправленное событие TouchEnter.
 TouchLeaveEvent	Определяет перенаправленное событие TouchLeave.
 TouchMoveEvent	Определяет перенаправленное событие TouchMove.
 TouchUpEvent	Определяет перенаправленное событие TouchUp.
 UidProperty	Идентифицирует свойство зависимостей Uid.
 VisibilityProperty	Идентифицирует свойство зависимостей Visibility.

Заметки
UIElement предоставляет начальную точка для характеристик структуры элементов, а также представляет виртуальные методы, которые могут переопределяться производными классами, что повлияет на поведение при отрисовке структуры элемента и его дочерних элементов.
Большая часть общего поведения элементов при вводе и фокусировании также определена в классе UIElement. Сюда относятся события ввода с клавиатуры, мыши и пера, а также связанные с ними свойства состояния. Множество таких событий являются маршрутизируемыми, и многие из связанных с вводом событий существуют как в версии восходящей маршрутизации, так и в туннелируемой версии события. Такие парные события обычно представляют наибольший интерес для разработчиков элементов управления.
UIElement также содержит API-интерфейсы, относящийся к модели событий WPF, включая методы, которые могут вызывать заданные перенаправленные события, источником которых является экземпляр элемента.
В терминах архитектуры, UIElement можно считать быть соответствующим дескриптора окна в программировании Win32, или элемент в программировании Динамический HTML (DHTML). UIElement базовый элемент в Уровень ядра WPF.
UIElement имеет следующие возможности, специально определенные классом UIElement:
Может визуализироваться как дочерний элемент (UIElement происходит от Visual, высокоуровневого графического класса)
Содержит логику, используемую для оценки размера и позиционирования возможных дочерних элементов UIElement (при интерпретации системой структуры)
Может отвечать на пользовательский ввод (в том числе управлять, куда направляются вводимые данные, посредством обработки маршрутизации событий или маршрутизации команд)
Может инициировать перенаправленные события, которые перемещаются по логическому дереву элементов
Поддерживает некоторые аспекты системы анимации
FrameworkElement является классом реализации уровня платформы WPF, который строит UIElement и добавляет конкретные взаимодействия с уровнем платформы WPF. FrameworkElement добавляет и определяет следующие возможности:
Дополнительные характеристики структуры для конкретной среды
Поддержка более функциональной отчетности метаданных по свойствам
Зависимая от класса реализация определенных входных базовых классов и прикрепленных к ним свойств или событий
Поддержка стилей
Расширенная поддержка анимации
Другим связанным классом является ContentElement. Класс ContentElement реализует множество тех же членов, что и UIElement; разница между этими двумя классами состоит в назначенном им месте в общей модели содержимого. Производной класс UIElement обычно определяет относительно жесткую модель содержимого, что означает существование ограничений на дочерние элементы в разметке. UIElement может иметь возможность принимать менее ограниченное дочернее содержимое, но эта возможность обычно централизована в выделенных свойствах содержимого. Производной класс ContentElement обычно не накладывает подобные ограничения на содержимое, обеспечивая поддержку таких скриптов, как документы переменного формата.