Конструкторы
  	Имя	Описание
	Application	Инициализирует новый экземпляр класса Application.

В начало страницы
Методы
  	Имя	Описание
	CheckAccess	Определяет, имеет ли вызывающий поток доступ к этому DispatcherObject. (Унаследовано от DispatcherObject.)
	Equals(Object)	Определяет, равен ли заданный объект Object текущему объекту Object. (Унаследовано от Object.)
	Finalize	Позволяет объекту Object попытаться освободить ресурсы и выполнить другие операции очистки, перед тем как объект Object будет утилизирован в процессе сборки мусора. (Унаследовано от Object.)
	FindResource	Осуществляет поиск ресурса пользовательский интерфейс, как например, Style или Brush, с указанным ключом и генерирует исключение, если запрошенный ресурс не найден (см. Общие сведения о ресурсах).
	GetContentStream	Возвращает поток ресурса для файла данных содержания, расположенного в указанном Uri (см. Ресурсы, Содержимое и Файлы данных WPF-приложения).
	GetCookie	Возвращает файл cookie для расположения, указанного Uri.
	GetHashCode	Играет роль хэш-функции для определенного типа. (Унаследовано от Object.)
	GetRemoteStream	Возвращает поток ресурса для исходного файла данных ресурса, расположенного в указанном Uri (см. Ресурсы, Содержимое и Файлы данных WPF-приложения).
	GetResourceStream	Возвращает поток ресурса для файла данных ресурса, расположенного в указанном Uri (см. Ресурсы, Содержимое и Файлы данных WPF-приложения).
	GetType	Возвращает объект Type для текущего экземпляра. (Унаследовано от Object.)
	LoadComponent(Uri)	Подгружает файл Язык XAML, располагающийся по указанному URI (uniform resource identifier — универсальный код ресурса), и преобразует его в экземпляр объекта, определенного корневым элементом файла Язык XAML.
	LoadComponent(Object, Uri)	Подгружает файл Язык XAML, располагающийся по указанному URI (uniform resource identifier — универсальный код ресурса) и преобразует его в экземпляр объекта, определенного корневым элементом файла Язык XAML.
	MemberwiseClone	Создает неполную копию текущего объекта Object. (Унаследовано от Object.)
	OnActivated	Вызывает событие Activated.
	OnDeactivated	Вызывает событие Deactivated.
	OnExit	Генерирует событие Exit.
	OnFragmentNavigation	Вызывает событие FragmentNavigation.
	OnLoadCompleted	Вызывает событие LoadCompleted.
	OnNavigated	Порождает событие Navigated.
	OnNavigating	Вызывает событие Navigating.
	OnNavigationFailed	Вызывает событие NavigationFailed.
	OnNavigationProgress	Вызывает событие NavigationProgress.
	OnNavigationStopped	Вызывает событие NavigationStopped.
	OnSessionEnding	Вызывает событие SessionEnding.
	OnStartup	Вызывает событие Startup.
	Run()	Запускает приложение Windows Presentation Foundation (WPF).
	Run(Window)	Запускает приложение Windows Presentation Foundation (WPF) и открывает указанное окно.
	SetCookie	Создает файл cookie для расположения, указанного Uri.
	Shutdown()	Завершить работу приложения.
	Shutdown(Int32)	Завершает работу приложения и передает указанный код завершения операционной системой.
	ToString	Возвращает объект String, который представляет текущий объект Object. (Унаследовано от Object.)
	TryFindResource	Осуществляет поиск указанного ресурса.
	VerifyAccess	Обеспечивает наличие у вызывающего потока доступ к этому DispatcherObject. (Унаследовано от DispatcherObject.)

В начало страницы
Свойства
  	Имя	Описание
	Current	Возвращает объект Application текущего AppDomain.
	Dispatcher	Возвращает объект Dispatcher, с которым связан этот объект DispatcherObject. (Унаследовано от DispatcherObject.)
	MainWindow	Получает или задает главное окно приложения.
	Properties	Возвращает коллекцию свойств области приложения.
	ResourceAssembly	Получает или задает Assembly, обеспечивающий набор URI (uniform resource identifiers — универсальные коды ресурса) для ресурсов приложения WPF.
	Resources	Получает или задает коллекцию ресурсов области приложения, например, стилей и кистей.
	ShutdownMode	Получает или задает условие, которое является причиной вызова метода Shutdown.
	StartupUri	Получает или задает Пользовательский интерфейс, отображающееся автоматически при запуске приложения.
	Windows	Возвращает созданные окна приложения. 

В начало страницы
События
  	Имя	Описание
	Activated	Происходит, когда приложение становиться активным.
	Deactivated	Происходит, когда приложение перестает быть активным.
	DispatcherUnhandledException	Происходит при генерации приложением исключения, которое не обрабатывается.
	Exit	Генерируется непосредственно перед завершением работы приложения и не может быть отменено.
	FragmentNavigation	Происходит, когда начинается переход к фрагменту содержимого, Переход происходит сразу же, если желаемый фрагмент находится в текущем содержимом, или после загрузки исходного содержимого Язык XAML, если желаемый фрагмент находится в другом содержимом.
	LoadCompleted	Происходит после того, как содержимое, переданное приложению, было загружено, проанализировано и обрабатывается.
	Navigated	Происходит, когда содержимое, к которому осуществляется переход, найдено, хотя его загрузка, возможно, еще не завершена.
	Navigating	Происходит при запросе приложением перехода.
	NavigationFailed	Происходит, когда происходит ошибка при переходе к указанному содержимому.
	NavigationProgress	Происходит время от времени во время загрузки, управляемой приложением для предоставления информации о статусе загрузки.
	NavigationStopped	Появляется при вызове метода перехода приложения StopLoading, или когда поступил запрос нового перехода во время выполнения текущего.
	SessionEnding	Происходит, когда пользователь завершает сеанс Windows, выходом из системы или завершая работу операционной системы.
	Startup	Происходит при вызове метода Run объекта Application.

В начало страницы
Явные реализации интерфейса
  	Имя	Описание
	IQueryAmbient.IsAmbientPropertyAvailable	Запрашивает, доступно ли заданное внешнее свойство в текущей области.